AAAAAGACACTTGCCCGCG -> AAAAGACACTTGCCCGCGT
AAAAAGAGAAACTAGCGAC -> AAAAGAGAAACTAGCGACA
AAAAATGGTTCGACGCAAG -> AAAATGGTTCGACGCAAGT
AAAAGACACTTGCCCGCGT -> AAAGACACTTGCCCGCGTT
AAAAGAGAAACTAGCGACA -> AAAGAGAAACTAGCGACAT
AAAAGGCTAGCACGCCTAT -> AAAGGCTAGCACGCCTATT
AAAAGTGTACAGAATTCGC -> AAAGTGTACAGAATTCGCC
AAAATGGAGACTCAAACCA -> AAATGGAGACTCAAACCAT
AAAATGGTTCGACGCAAGT -> AAATGGTTCGACGCAAGTC
AAAATTTCAGGTTGCCTTG -> AAATTTCAGGTTGCCTTGA
AAACCAGGACCGTTATCAG -> AACCAGGACCGTTATCAGA
AAACCATAGTATCGCGAAC -> AACCATAGTATCGCGAACT
AAACCGCCCGAGGGGTTCA -> AACCGCCCGAGGGGTTCAT
AAACCGGTAGCCCAACATG -> AACCGGTAGCCCAACATGC
AAACGATCATCTTCATCTG -> AACGATCATCTTCATCTGG
AAACTAGCGACATCACAAT -> AACTAGCGACATCACAATG
AAACTATGCGCGATCCTAC -> AACTATGCGCGATCCTACC
AAAGAAGTCCCGGACTCAT -> AAGAAGTCCCGGACTCATT
AAAGACACTTGCCCGCGTT -> AAGACACTTGCCCGCGTTC
AAAGAGAAACTAGCGACAT -> AAGAGAAACTAGCGACATC
AAAGATTTGCAGGGAAAAA -> AAGATTTGCAGGGAAAAAG
AAAGCAAAATTTCAGGTTG -> AAGCAAAATTTCAGGTTGC
AAAGCACGAGACATAACTA -> AAGCACGAGACATAACTAA
AAAGCCGCAACGAGGAAGT -> AAGCCGCAACGAGGAAGTA
AAAGCGGGAGCCTGGTCTC -> AAGCGGGAGCCTGGTCTCT
AAAGGCTAGCACGCCTATT -> AAGGCTAGCACGCCTATTA
AAAGGGAGCTACAAGAGTT -> AAGGGAGCTACAAGAGTTA
AAAGTCAAAAAGACACTTG -> AAGTCAAAAAGACACTTGC
AAAGTGTACAGAATTCGCC -> AAGTGTACAGAATTCGCCA
AAAGTGTACTAAGCGATGA -> AAGTGTACTAAGCGATGAT
AAATGGAGACTCAAACCAT -> AATGGAGACTCAAACCATA
AAATGGCTGTACGTTTTTG -> AATGGCTGTACGTTTTTGC
AAATGGTTCGACGCAAGTC -> AATGGTTCGACGCAAGTCG
AAATGTTGCCAGAGAGAGT -> AATGTTGCCAGAGAGAGTG
AAATTAAACGATCATCTTC -> AATTAAACGATCATCTTCA
AAATTTCAGGTTGCCTTGA -> AATTTCAGGTTGCCTTGAG
AACAAGAAGTCGACGACGT -> ACAAGAAGTCGACGACGTC
AACAATTTAATCCGGCTCA -> ACAATTTAATCCGGCTCAC
AACACAATTCGTGGTATAC -> ACACAATTCGTGGTATACC
AACACTGTATCTCTAGCTG -> ACACTGTATCTCTAGCTGC
AACACTTCGCATAGTAGGG -> ACACTTCGCATAGTAGGGC
AACAGAGAATTCGATTGCA -> ACAGAGAATTCGATTGCAA
AACATCAGCCGGTTGGCCA -> ACATCAGCCGGTTGGCCAG
AACATGCTGTGGTTAGGCC -> ACATGCTGTGGTTAGGCCA
AACCAGGACCGTTATCAGA -> ACCAGGACCGTTATCAGAG
AACCATACTGATCGATCGT -> ACCATACTGATCGATCGTC
AACCATAGTATCGCGAACT -> ACCATAGTATCGCGAACTA
AACCCAACTGTCGCGTTCA -> ACCCAACTGTCGCGTTCAT
AACCGCCCGAGGGGTTCAT -> ACCGCCCGAGGGGTTCATC
AACCGGACCTTTGGACCAA -> ACCGGACCTTTGGACCAAC
AACCGGTAGCCCAACATGC -> ACCGGTAGCCCAACATGCT
AACCGTATATGGCGTCTAA -> ACCGTATATGGCGTCTAAG
AACGAGGAAGTACCTGCAT -> ACGAGGAAGTACCTGCATT
AACGATAAGCCTCCTACAA -> ACGATAAGCCTCCTACAAC
AACGATCATCTTCATCTGG -> ACGATCATCTTCATCTGGA
AACGCTGAGGCTCCGGATC -> ACGCTGAGGCTCCGGATCC
AACGGCCCAACCCAACTGT -> ACGGCCCAACCCAACTGTC
AACGGCTACACGGTCACGA -> ACGGCTACACGGTCACGAC
AACGTACTCACGATGTGCC -> ACGTACTCACGATGTGCCC
AACTAAAGTGTACTAAGCG -> ACTAAAGTGTACTAAGCGA
AACTAACGGCCCAACCCAA -> ACTAACGGCCCAACCCAAC
AACTACAAGAGTTAAGAGC -> ACTACAAGAGTTAAGAGCA
AACTAGCGACATCACAATG -> ACTAGCGACATCACAATGC
AACTAGCGGCCTCCGCCCT -> ACTAGCGGCCTCCGCCCTG
AACTATGCGCGATCCTACC -> ACTATGCGCGATCCTACCA
AACTGATACCCAAAAATGG -> ACTGATACCCAAAAATGGT
AACTGCACCCCCAAAGCAA -> ACTGCACCCCCAAAGCAAA
AACTGTACAATCTTCGTTC -> ACTGTACAATCTTCGTTCT
AACTGTCGCGTTCATCAAG -> ACTGTCGCGTTCATCAAGT
AACTTTTGTAACTGTACAA -> ACTTTTGTAACTGTACAAT
AAGAAGTCCCGGACTCATT -> AGAAGTCCCGGACTCATTG
AAGAAGTCGACGACGTCTA -> AGAAGTCGACGACGTCTAA
AAGACACGATCGCCGGAGA -> AGACACGATCGCCGGAGAA
AAGACACTTGCCCGCGTTC -> AGACACTTGCCCGCGTTCA
AAGAGAAACTAGCGACATC -> AGAGAAACTAGCGACATCA
AAGAGCAAGTCAAGCCCAT -> AGAGCAAGTCAAGCCCATG
AAGAGCACCCTATATTCAT -> AGAGCACCCTATATTCATG
AAGAGCAGCTCCCGGCCCT -> AGAGCAGCTCCCGGCCCTG
AAGAGCATGGTTCCCCAGT -> AGAGCATGGTTCCCCAGTG
AAGAGTGGGGAAATGTTGC -> AGAGTGGGGAAATGTTGCC
AAGAGTTAAGAGCAAGTCA -> AGAGTTAAGAGCAAGTCAA
AAGAGTTAAGAGCACCCTA -> AGAGTTAAGAGCACCCTAT
AAGAGTTAAGAGCAGCTCC -> AGAGTTAAGAGCAGCTCCC
AAGAGTTAAGAGCATGGTT -> AGAGTTAAGAGCATGGTTC
AAGATATAGTATCATCCCT -> AGATATAGTATCATCCCTT
AAGATTTGCAGGGAAAAAG -> AGATTTGCAGGGAAAAAGA
AAGCAAAATTTCAGGTTGC -> AGCAAAATTTCAGGTTGCC
AAGCACGAGACATAACTAA -> AGCACGAGACATAACTAAA
AAGCAGTCCAAAGGGAGCT -> AGCAGTCCAAAGGGAGCTA
AAGCCACCGGTACACGTGC -> AGCCACCGGTACACGTGCC
AAGCCATACACGGTTAGAT -> AGCCATACACGGTTAGATG
AAGCCCATGTATTCTTGTA -> AGCCCATGTATTCTTGTAC
AAGCCGCAACGAGGAAGTA -> AGCCGCAACGAGGAAGTAC
AAGCCGGCACAGAGTCCGT -> AGCCGGCACAGAGTCCGTG
AAGCCTCCTACAACACTTC -> AGCCTCCTACAACACTTCG
AAGCGAGGGAGCAATCGTA -> AGCGAGGGAGCAATCGTAT
AAGCGATGATCGTCGAGCT -> AGCGATGATCGTCGAGCTA
AAGCGGGAGCCTGGTCTCT -> AGCGGGAGCCTGGTCTCTC
AAGCGTAACCGGACCTTTG -> AGCGTAACCGGACCTTTGG
AAGCGTCTCAACATCAGCC -> AGCGTCTCAACATCAGCCG
AAGCTCTCACTCTTCGGAG -> AGCTCTCACTCTTCGGAGG
AAGGAGCCTCAGCAGCCGA -> AGGAGCCTCAGCAGCCGAG
AAGGCCACGAAAAGGCTAG -> AGGCCACGAAAAGGCTAGC
AAGGCTAGCACGCCTATTA -> AGGCTAGCACGCCTATTAA
AAGGGAGCTACAAGAGTTA -> AGGGAGCTACAAGAGTTAA
AAGGGTATGCGTGTTCTGT -> AGGGTATGCGTGTTCTGTG
AAGGGTCGCTGCACTTAGA -> AGGGTCGCTGCACTTAGAG
AAGGTAAGCGAGGGAGCAA -> AGGTAAGCGAGGGAGCAAT
AAGTACCTGCATTCTTTAG -> AGTACCTGCATTCTTTAGT
AAGTATCAGAACCGTATAT -> AGTATCAGAACCGTATATG
AAGTCAAAAAGACACTTGC -> AGTCAAAAAGACACTTGCC
AAGTCAAACCAGGACCGTT -> AGTCAAACCAGGACCGTTA
AAGTCAAGCCCATGTATTC -> AGTCAAGCCCATGTATTCT
AAGTCCCGGACTCATTGGA -> AGTCCCGGACTCATTGGAG
AAGTCGACGACGTCTAAGC -> AGTCGACGACGTCTAAGCA
AAGTCGATCTGCCTGATTA -> AGTCGATCTGCCTGATTAA
AAGTCGATTTGCAACTTTT -> AGTCGATTTGCAACTTTTG
AAGTCGTGCCAGACAAACC -> AGTCGTGCCAGACAAACCG
AAGTGTACAGAATTCGCCA -> AGTGTACAGAATTCGCCAA
AAGTGTACTAAGCGATGAT -> AGTGTACTAAGCGATGATC
AAGTTGTACCGGAGTAGAT -> AGTTGTACCGGAGTAGATA
AATAGCAGTTAGATCGGTT -> ATAGCAGTTAGATCGGTTT
AATCAAGCCGGCACAGAGT -> ATCAAGCCGGCACAGAGTC
AATCCGGCTCACGTTACAG -> ATCCGGCTCACGTTACAGA
AATCGAGCTAGCGGGCTAG -> ATCGAGCTAGCGGGCTAGT
AATCGTATCTGATTTCCCC -> ATCGTATCTGATTTCCCCA
AATCTGGGCGAGGACATAT -> ATCTGGGCGAGGACATATT
AATCTGTTCGCGGATGTGT -> ATCTGTTCGCGGATGTGTG
AATCTTCGTTCTAGTCTGG -> ATCTTCGTTCTAGTCTGGG
AATGCAAGTCGATCTGCCT -> ATGCAAGTCGATCTGCCTG
AATGCTGCAGCCAACACTG -> ATGCTGCAGCCAACACTGT
AATGGAGACTCAAACCATA -> ATGGAGACTCAAACCATAG
AATGGCTGTACGTTTTTGC -> ATGGCTGTACGTTTTTGCT
AATGGTTCGACGCAAGTCG -> ATGGTTCGACGCAAGTCGT
AATGTAAGCTCTCACTCTT -> ATGTAAGCTCTCACTCTTC
AATGTGAAAATGGAGACTC -> ATGTGAAAATGGAGACTCA
AATGTTGCCAGAGAGAGTG -> ATGTTGCCAGAGAGAGTGC
AATTAAACGATCATCTTCA -> ATTAAACGATCATCTTCAT
AATTATTAAACTATGCGCG -> ATTATTAAACTATGCGCGA
AATTCACATTACAACGCTG -> ATTCACATTACAACGCTGA
AATTCGATTGCAACGTACT -> ATTCGATTGCAACGTACTC
AATTCGCCAAATTAAACGA -> ATTCGCCAAATTAAACGAT
AATTCGTGGTATACCACCC -> ATTCGTGGTATACCACCCT
AATTGTATCCGTGTAGTCG -> ATTGTATCCGTGTAGTCGA
AATTTAATCCGGCTCACGT -> ATTTAATCCGGCTCACGTT
AATTTCAGGTTGCCTTGAG -> ATTTCAGGTTGCCTTGAGT
ACAAACCGGTAGCCCAACA -> CAAACCGGTAGCCCAACAT
ACAACACTTCGCATAGTAG -> CAACACTTCGCATAGTAGG
ACAACCATACTGATCGATC -> CAACCATACTGATCGATCG
ACAACGCTGAGGCTCCGGA -> CAACGCTGAGGCTCCGGAT
ACAAGAAGTCGACGACGTC -> CAAGAAGTCGACGACGTCT
ACAAGACACGATCGCCGGA -> CAAGACACGATCGCCGGAG
ACAAGAGTTAAGAGCAAGT -> CAAGAGTTAAGAGCAAGTC
ACAAGAGTTAAGAGCACCC -> CAAGAGTTAAGAGCACCCT
ACAAGAGTTAAGAGCAGCT -> CAAGAGTTAAGAGCAGCTC
ACAAGAGTTAAGAGCATGG -> CAAGAGTTAAGAGCATGGT
ACAAGCCATACACGGTTAG -> CAAGCCATACACGGTTAGA
ACAAGCGTCTCAACATCAG -> CAAGCGTCTCAACATCAGC
ACAAGGAGCCTCAGCAGCC -> CAAGGAGCCTCAGCAGCCG
ACAATCTTCGTTCTAGTCT -> CAATCTTCGTTCTAGTCTG
ACAATGCAAGTCGATCTGC -> CAATGCAAGTCGATCTGCC
ACAATTCGTGGTATACCAC -> CAATTCGTGGTATACCACC
ACAATTTAATCCGGCTCAC -> CAATTTAATCCGGCTCACG
ACACAACCATACTGATCGA -> CACAACCATACTGATCGAT
ACACAATTCGTGGTATACC -> CACAATTCGTGGTATACCA
ACACGATCGCCGGAGAATG -> CACGATCGCCGGAGAATGT
ACACGGTCACGACAGCACA -> CACGGTCACGACAGCACAT
ACACGGTTAGATGTGATCG -> CACGGTTAGATGTGATCGT
ACACGTGCCCGTCGCTTCT -> CACGTGCCCGTCGCTTCTT
ACACTACTGAACAATTTAA -> CACTACTGAACAATTTAAT
ACACTGTATCTCTAGCTGC -> CACTGTATCTCTAGCTGCC
ACACTTCGCATAGTAGGGC -> CACTTCGCATAGTAGGGCC
ACACTTGCCCGCGTTCAGA -> CACTTGCCCGCGTTCAGAT
ACAGAATTCGCCAAATTAA -> CAGAATTCGCCAAATTAAA
ACAGAGAATTCGATTGCAA -> CAGAGAATTCGATTGCAAC
ACAGAGTCCGTGAGGCTAC -> CAGAGTCCGTGAGGCTACA
ACAGAGTCGGCAATCAAGC -> CAGAGTCGGCAATCAAGCC
ACAGCAATCTGGGCGAGGA -> CAGCAATCTGGGCGAGGAC
ACAGCACATGTACTAACTA -> CAGCACATGTACTAACTAC
ACAGCCTGTTGGATCAGTT -> CAGCCTGTTGGATCAGTTA
ACATAACTAAAGTGTACTA -> CATAACTAAAGTGTACTAA
ACATATTAAGGTAAGCGAG -> CATATTAAGGTAAGCGAGG
ACATCACAATGCAAGTCGA -> CATCACAATGCAAGTCGAT
ACATCAGCCGGTTGGCCAG -> CATCAGCCGGTTGGCCAGG
ACATCTACCGATCGCCTGC -> CATCTACCGATCGCCTGCC
ACATGCTGTGGTTAGGCCA -> CATGCTGTGGTTAGGCCAT
ACATGTACTAACTACAAGA -> CATGTACTAACTACAAGAG
ACATTACAACGCTGAGGCT -> CATTACAACGCTGAGGCTC
ACATTGCCCTTCGTCCGCT -> CATTGCCCTTCGTCCGCTC
ACCAACACAATTCGTGGTA -> CCAACACAATTCGTGGTAT
ACCACCCTCCCTTCCATGA -> CCACCCTCCCTTCCATGAG
ACCAGGACCGTTATCAGAG -> CCAGGACCGTTATCAGAGG
ACCAGGAGTTTCGACGTGC -> CCAGGAGTTTCGACGTGCT
ACCATACTGATCGATCGTC -> CCATACTGATCGATCGTCT
ACCATAGTATCGCGAACTA -> CCATAGTATCGCGAACTAG
ACCATATGGTATTTTGCGA -> CCATATGGTATTTTGCGAA
ACCCAAAAATGGTTCGACG -> CCCAAAAATGGTTCGACGC
ACCCAACTGTCGCGTTCAT -> CCCAACTGTCGCGTTCATC
ACCCCATCAATTCACATTA -> CCCCATCAATTCACATTAC
ACCCCCAAAGCAAAATTTC -> CCCCCAAAGCAAAATTTCA
ACCCGTGCACACTACTGAA -> CCCGTGCACACTACTGAAC
ACCCTATATTCATGTATTC -> CCCTATATTCATGTATTCT
ACCCTCCCTTCCATGAGAT -> CCCTCCCTTCCATGAGATG
ACCGATCGCCTGCCTCCCG -> CCGATCGCCTGCCTCCCGT
ACCGCCCGAGGGGTTCATC -> CCGCCCGAGGGGTTCATCT
ACCGCCGGACACAACCATA -> CCGCCGGACACAACCATAC
ACCGCGTACCATATGGTAT -> CCGCGTACCATATGGTATT
ACCGCGTCAGTTCACGACA -> CCGCGTCAGTTCACGACAA
ACCGCTTAAGATATAGTAT -> CCGCTTAAGATATAGTATC
ACCGGACCTTTGGACCAAC -> CCGGACCTTTGGACCAACA
ACCGGAGTAGATACTGTCG -> CCGGAGTAGATACTGTCGG
ACCGGTACACGTGCCCGTC -> CCGGTACACGTGCCCGTCG
ACCGGTAGCCCAACATGCT -> CCGGTAGCCCAACATGCTG
ACCGTATATGGCGTCTAAG -> CCGTATATGGCGTCTAAGG
ACCGTTATCAGAGGATACC -> CCGTTATCAGAGGATACCC
ACCTAGGTGTGGTTTCTGC -> CCTAGGTGTGGTTTCTGCT
ACCTGCATTCTTTAGTTGT -> CCTGCATTCTTTAGTTGTG
ACCTTATTATGCTTGCTTA -> CCTTATTATGCTTGCTTAT
ACCTTCTTTGCCTGGTAAG -> CCTTCTTTGCCTGGTAAGA
ACCTTTGGACCAACACAAT -> CCTTTGGACCAACACAATT
ACGAAAAGGCTAGCACGCC -> CGAAAAGGCTAGCACGCCT
ACGACAAGCGTCTCAACAT -> CGACAAGCGTCTCAACATC
ACGACAAGGAGCCTCAGCA -> CGACAAGGAGCCTCAGCAG
ACGACAGCACATGTACTAA -> CGACAGCACATGTACTAAC
ACGACGTCTAAGCAGTCCA -> CGACGTCTAAGCAGTCCAA
ACGAGACATAACTAAAGTG -> CGAGACATAACTAAAGTGT
ACGAGGAAGTACCTGCATT -> CGAGGAAGTACCTGCATTC
ACGATAAGCCTCCTACAAC -> CGATAAGCCTCCTACAACA
ACGATCATCTTCATCTGGA -> CGATCATCTTCATCTGGAC
ACGATCGCCGGAGAATGTG -> CGATCGCCGGAGAATGTGA
ACGATGTGCCCAACAAGAA -> CGATGTGCCCAACAAGAAG
ACGCAAGTCGTGCCAGACA -> CGCAAGTCGTGCCAGACAA
ACGCAATAGCAGTTAGATC -> CGCAATAGCAGTTAGATCG
ACGCCTATTAAAGAAGTCC -> CGCCTATTAAAGAAGTCCC
ACGCGCACAGCAATCTGGG -> CGCGCACAGCAATCTGGGC
ACGCTGAGGCTCCGGATCC -> CGCTGAGGCTCCGGATCCC
ACGGATTTAAAAGTGTACA -> CGGATTTAAAAGTGTACAG
ACGGCCCAACCCAACTGTC -> CGGCCCAACCCAACTGTCG
ACGGCTACACGGTCACGAC -> CGGCTACACGGTCACGACA
ACGGGTGAGCCAGCGGGCC -> CGGGTGAGCCAGCGGGCCG
ACGGTCACGACAGCACATG -> CGGTCACGACAGCACATGT
ACGGTTAGATGTGATCGTA -> CGGTTAGATGTGATCGTAG
ACGTAAAGATTTGCAGGGA -> CGTAAAGATTTGCAGGGAA
ACGTACTCACGATGTGCCC -> CGTACTCACGATGTGCCCA
ACGTCAGTAGGTAGTCCAT -> CGTCAGTAGGTAGTCCATC
ACGTCTAAGCAGTCCAAAG -> CGTCTAAGCAGTCCAAAGG
ACGTGCCCGTCGCTTCTTG -> CGTGCCCGTCGCTTCTTGA
ACGTGCTCGGATGGACTGG -> CGTGCTCGGATGGACTGGT
ACGTTACAGAGTCGGCAAT -> CGTTACAGAGTCGGCAATC
ACGTTTTTGCTGTCTGGGA -> CGTTTTTGCTGTCTGGGAG
ACTAAAGTGTACTAAGCGA -> CTAAAGTGTACTAAGCGAT
ACTAACGGCCCAACCCAAC -> CTAACGGCCCAACCCAACT
ACTAACTACAAGAGTTAAG -> CTAACTACAAGAGTTAAGA
ACTAAGCGATGATCGTCGA -> CTAAGCGATGATCGTCGAG
ACTAAGTATCAGAACCGTA -> CTAAGTATCAGAACCGTAT
ACTACAAGAGTTAAGAGCA -> CTACAAGAGTTAAGAGCAA
ACTACCGCCGGACACAACC -> CTACCGCCGGACACAACCA
ACTACCGCGTACCATATGG -> CTACCGCGTACCATATGGT
ACTACCGCGTCAGTTCACG -> CTACCGCGTCAGTTCACGA
ACTACCGCTTAAGATATAG -> CTACCGCTTAAGATATAGT
ACTACTGAACAATTTAATC -> CTACTGAACAATTTAATCC
ACTAGCGACATCACAATGC -> CTAGCGACATCACAATGCA
ACTAGCGGCCTCCGCCCTG -> CTAGCGGCCTCCGCCCTGC
ACTATGCGCGATCCTACCA -> CTATGCGCGATCCTACCAG
ACTCAAACCATAGTATCGC -> CTCAAACCATAGTATCGCG
ACTCACGATGTGCCCAACA -> CTCACGATGTGCCCAACAA
ACTCATTGGAGAGACAAGC -> CTCATTGGAGAGACAAGCC
ACTCGCGGAGTCGCTCATA -> CTCGCGGAGTCGCTCATAA
ACTCTTCGGAGGAGGCAGA -> CTCTTCGGAGGAGGCAGAC
ACTGAACAATTTAATCCGG -> CTGAACAATTTAATCCGGC
ACTGATACCCAAAAATGGT -> CTGATACCCAAAAATGGTT
ACTGATCGATCGTCTACAA -> CTGATCGATCGTCTACAAG
ACTGCACCCCCAAAGCAAA -> CTGCACCCCCAAAGCAAAA
ACTGTACAATCTTCGTTCT -> CTGTACAATCTTCGTTCTA
ACTGTATCTCTAGCTGCCT -> CTGTATCTCTAGCTGCCTG
ACTGTCGCGTTCATCAAGT -> CTGTCGCGTTCATCAAGTC
ACTGTCGGTATAGGTTGTA -> CTGTCGGTATAGGTTGTAC
ACTTAGAGCTGCTAATGTA -> CTTAGAGCTGCTAATGTAA
ACTTCGCATAGTAGGGCCA -> CTTCGCATAGTAGGGCCAC
ACTTGCCCGCGTTCAGATC -> CTTGCCCGCGTTCAGATCG
ACTTTTGTAACTGTACAAT -> CTTTTGTAACTGTACAATC
AGAAACTAGCGACATCACA -> GAAACTAGCGACATCACAA
AGAAAGTCAAAAAGACACT -> GAAAGTCAAAAAGACACTT
AGAACCGTATATGGCGTCT -> GAACCGTATATGGCGTCTA
AGAAGTCCCGGACTCATTG -> GAAGTCCCGGACTCATTGG
AGAAGTCGACGACGTCTAA -> GAAGTCGACGACGTCTAAG
AGAATGTGAAAATGGAGAC -> GAATGTGAAAATGGAGACT
AGAATTCGATTGCAACGTA -> GAATTCGATTGCAACGTAC
AGAATTCGCCAAATTAAAC -> GAATTCGCCAAATTAAACG
AGACAAACCGGTAGCCCAA -> GACAAACCGGTAGCCCAAC
AGACAAGCCATACACGGTT -> GACAAGCCATACACGGTTA
AGACACGATCGCCGGAGAA -> GACACGATCGCCGGAGAAT
AGACACTTGCCCGCGTTCA -> GACACTTGCCCGCGTTCAG
AGACATAACTAAAGTGTAC -> GACATAACTAAAGTGTACT
AGACGCGCACAGCAATCTG -> GACGCGCACAGCAATCTGG
AGACTCAAACCATAGTATC -> GACTCAAACCATAGTATCG
AGACTCGCGGAGTCGCTCA -> GACTCGCGGAGTCGCTCAT
AGAGAAACTAGCGACATCA -> GAGAAACTAGCGACATCAC
AGAGAATTCGATTGCAACG -> GAGAATTCGATTGCAACGT
AGAGACAAGCCATACACGG -> GAGACAAGCCATACACGGT
AGAGAGAGTGCAACTAACG -> GAGAGAGTGCAACTAACGG
AGAGAGTGCAACTAACGGC -> GAGAGTGCAACTAACGGCC
AGAGCAAGTCAAGCCCATG -> GAGCAAGTCAAGCCCATGT
AGAGCACCCTATATTCATG -> GAGCACCCTATATTCATGT
AGAGCAGCTCCCGGCCCTG -> GAGCAGCTCCCGGCCCTGT
AGAGCATGGTTCCCCAGTG -> GAGCATGGTTCCCCAGTGT
AGAGCTGCTAATGTAAGCT -> GAGCTGCTAATGTAAGCTC
AGAGGATACCCGTGCACAC -> GAGGATACCCGTGCACACT
AGAGTCCGTGAGGCTACAT -> GAGTCCGTGAGGCTACATC
AGAGTCGGCAATCAAGCCG -> GAGTCGGCAATCAAGCCGG
AGAGTGCAACTAACGGCCC -> GAGTGCAACTAACGGCCCA
AGAGTGGGGAAATGTTGCC -> GAGTGGGGAAATGTTGCCA
AGAGTTAAGAGCAAGTCAA -> GAGTTAAGAGCAAGTCAAG
AGAGTTAAGAGCACCCTAT -> GAGTTAAGAGCACCCTATA
AGAGTTAAGAGCAGCTCCC -> GAGTTAAGAGCAGCTCCCG
AGAGTTAAGAGCATGGTTC -> GAGTTAAGAGCATGGTTCC
AGATACTGTCGGTATAGGT -> GATACTGTCGGTATAGGTT
AGATATAGTATCATCCCTT -> GATATAGTATCATCCCTTT
AGATCGGTTTGGGGCGAAG -> GATCGGTTTGGGGCGAAGG
AGATCGTCTATCCTACAAG -> GATCGTCTATCCTACAAGA
AGATGGCCGCTGACCTAGG -> GATGGCCGCTGACCTAGGT
AGATGTGATCGTAGACGCG -> GATGTGATCGTAGACGCGC
AGATTTGCAGGGAAAAAGA -> GATTTGCAGGGAAAAAGAG
AGCAAAATTTCAGGTTGCC -> GCAAAATTTCAGGTTGCCT
AGCAAGTCAAGCCCATGTA -> GCAAGTCAAGCCCATGTAT
AGCAATCGTATCTGATTTC -> GCAATCGTATCTGATTTCC
AGCAATCTGGGCGAGGACA -> GCAATCTGGGCGAGGACAT
AGCACATGTACTAACTACA -> GCACATGTACTAACTACAA
AGCACCCTATATTCATGTA -> GCACCCTATATTCATGTAT
AGCACGAGACATAACTAAA -> GCACGAGACATAACTAAAG
AGCACGCCTATTAAAGAAG -> GCACGCCTATTAAAGAAGT
AGCACGGATTTAAAAGTGT -> GCACGGATTTAAAAGTGTA
AGCAGCCGAGGCATCCTGT -> GCAGCCGAGGCATCCTGTG
AGCAGCTCCCGGCCCTGTA -> GCAGCTCCCGGCCCTGTAT
AGCAGTCCAAAGGGAGCTA -> GCAGTCCAAAGGGAGCTAC
AGCAGTTAGATCGGTTTGG -> GCAGTTAGATCGGTTTGGG
AGCATGGTTCCCCAGTGTA -> GCATGGTTCCCCAGTGTAT
AGCATTAATCGAGCTAGCG -> GCATTAATCGAGCTAGCGG
AGCCAACACTGTATCTCTA -> GCCAACACTGTATCTCTAG
AGCCACCGGTACACGTGCC -> GCCACCGGTACACGTGCCC
AGCCAGCGGGCCGGGCTGG -> GCCAGCGGGCCGGGCTGGG
AGCCATACACGGTTAGATG -> GCCATACACGGTTAGATGT
AGCCCAACATGCTGTGGTT -> GCCCAACATGCTGTGGTTA
AGCCCATGTATTCTTGTAC -> GCCCATGTATTCTTGTACT
AGCCGAGGCATCCTGTGGC -> GCCGAGGCATCCTGTGGCC
AGCCGCAACGAGGAAGTAC -> GCCGCAACGAGGAAGTACC
AGCCGGCACAGAGTCCGTG -> GCCGGCACAGAGTCCGTGA
AGCCGGTTGGCCAGGCGGC -> GCCGGTTGGCCAGGCGGCG
AGCCTCAGCAGCCGAGGCA -> GCCTCAGCAGCCGAGGCAT
AGCCTCCTACAACACTTCG -> GCCTCCTACAACACTTCGC
AGCCTGGTCTCTCGAGTGC -> GCCTGGTCTCTCGAGTGCC
AGCCTGTTGGATCAGTTAC -> GCCTGTTGGATCAGTTACG
AGCGACATCACAATGCAAG -> GCGACATCACAATGCAAGT
AGCGAGGGAGCAATCGTAT -> GCGAGGGAGCAATCGTATC
AGCGATGATCGTCGAGCTA -> GCGATGATCGTCGAGCTAA
AGCGCACGTAAAGATTTGC -> GCGCACGTAAAGATTTGCA
AGCGGCCTCCGCCCTGCTT -> GCGGCCTCCGCCCTGCTTG
AGCGGGAGCCTGGTCTCTC -> GCGGGAGCCTGGTCTCTCG
AGCGGGCCGGGCTGGGTGG -> GCGGGCCGGGCTGGGTGGT
AGCGGGCTAGTTCTGGGTT -> GCGGGCTAGTTCTGGGTTT
AGCGGGTCGAGTATAAATG -> GCGGGTCGAGTATAAATGG
AGCGTAACCGGACCTTTGG -> GCGTAACCGGACCTTTGGA
AGCGTCTCAACATCAGCCG -> GCGTCTCAACATCAGCCGG
AGCTAAAGCCGCAACGAGG -> GCTAAAGCCGCAACGAGGA
AGCTACAAGAGTTAAGAGC -> GCTACAAGAGTTAAGAGCA
AGCTAGCGGGCTAGTTCTG -> GCTAGCGGGCTAGTTCTGG
AGCTCCCGGCCCTGTATTC -> GCTCCCGGCCCTGTATTCT
AGCTCTCACTCTTCGGAGG -> GCTCTCACTCTTCGGAGGA
AGCTGCCTGACGACAAGGA -> GCTGCCTGACGACAAGGAG
AGCTGCTAATGTAAGCTCT -> GCTGCTAATGTAAGCTCTC
AGGAAGTACCTGCATTCTT -> GGAAGTACCTGCATTCTTT
AGGACATATTAAGGTAAGC -> GGACATATTAAGGTAAGCG
AGGACCGTTATCAGAGGAT -> GGACCGTTATCAGAGGATA
AGGAGCCTCAGCAGCCGAG -> GGAGCCTCAGCAGCCGAGG
AGGAGGCAGACTCGCGGAG -> GGAGGCAGACTCGCGGAGT
AGGAGTTTCGACGTGCTCG -> GGAGTTTCGACGTGCTCGG
AGGATACCCGTGCACACTA -> GGATACCCGTGCACACTAC
AGGATAGCGGGTCGAGTAT -> GGATAGCGGGTCGAGTATA
AGGCAGACTCGCGGAGTCG -> GGCAGACTCGCGGAGTCGC
AGGCATCCTGTGGCCTGTG -> GGCATCCTGTGGCCTGTGG
AGGCCACGAAAAGGCTAGC -> GGCCACGAAAAGGCTAGCA
AGGCCATAAAGCACGAGAC -> GGCCATAAAGCACGAGACA
AGGCGGCGAACGATAAGCC -> GGCGGCGAACGATAAGCCT
AGGCTACATCTACCGATCG -> GGCTACATCTACCGATCGC
AGGCTAGCACGCCTATTAA -> GGCTAGCACGCCTATTAAA
AGGCTCCGGATCCCACAGC -> GGCTCCGGATCCCACAGCC
AGGGAAAAAGAGAAACTAG -> GGGAAAAAGAGAAACTAGC
AGGGAGCAATCGTATCTGA -> GGGAGCAATCGTATCTGAT
AGGGAGCTACAAGAGTTAA -> GGGAGCTACAAGAGTTAAG
AGGGCCACCCCATCAATTC -> GGGCCACCCCATCAATTCA
AGGGGTTCATCTAATCTGT -> GGGGTTCATCTAATCTGTT
AGGGTACCTTCTTTGCCTG -> GGGTACCTTCTTTGCCTGG
AGGGTATGCGTGTTCTGTG -> GGGTATGCGTGTTCTGTGG
AGGGTCGCTGCACTTAGAG -> GGGTCGCTGCACTTAGAGC
AGGTAAGCGAGGGAGCAAT -> GGTAAGCGAGGGAGCAATC
AGGTAGTCCATCGTTCCCA -> GGTAGTCCATCGTTCCCAG
AGGTGTGGTTTCTGCTTCA -> GGTGTGGTTTCTGCTTCAA
AGGTTGCCTTGAGTTGAAA -> GGTTGCCTTGAGTTGAAAC
AGGTTGTACTAAGTATCAG -> GGTTGTACTAAGTATCAGA
AGTACCTGCATTCTTTAGT -> GTACCTGCATTCTTTAGTT
AGTAGATACTGTCGGTATA -> GTAGATACTGTCGGTATAG
AGTAGGGCCACCCCATCAA -> GTAGGGCCACCCCATCAAT
AGTAGGTAGTCCATCGTTC -> GTAGGTAGTCCATCGTTCC
AGTATAAATGGCTGTACGT -> GTATAAATGGCTGTACGTT
AGTATCAGAACCGTATATG -> GTATCAGAACCGTATATGG
AGTATCATCCCTTTAACGG -> GTATCATCCCTTTAACGGC
AGTATCGCGAACTAGCGGC -> GTATCGCGAACTAGCGGCC
AGTCAAAAAGACACTTGCC -> GTCAAAAAGACACTTGCCC
AGTCAAACCAGGACCGTTA -> GTCAAACCAGGACCGTTAT
AGTCAAGCCCATGTATTCT -> GTCAAGCCCATGTATTCTT
AGTCCAAAGGGAGCTACAA -> GTCCAAAGGGAGCTACAAG
AGTCCATCGTTCCCAGCAC -> GTCCATCGTTCCCAGCACG
AGTCCCGGACTCATTGGAG -> GTCCCGGACTCATTGGAGA
AGTCCGTGAGGCTACATCT -> GTCCGTGAGGCTACATCTA
AGTCGACAAGACACGATCG -> GTCGACAAGACACGATCGC
AGTCGACGACGTCTAAGCA -> GTCGACGACGTCTAAGCAG
AGTCGATCTGCCTGATTAA -> GTCGATCTGCCTGATTAAT
AGTCGATTTGCAACTTTTG -> GTCGATTTGCAACTTTTGT
AGTCGCTCATAACTGATAC -> GTCGCTCATAACTGATACC
AGTCGGCAATCAAGCCGGC -> GTCGGCAATCAAGCCGGCA
AGTCGTGCCAGACAAACCG -> GTCGTGCCAGACAAACCGG
AGTCTGGGGATAGCATTAA -> GTCTGGGGATAGCATTAAT
AGTGCAACTAACGGCCCAA -> GTGCAACTAACGGCCCAAC
AGTGCCGCGTTATACGCAA -> GTGCCGCGTTATACGCAAT
AGTGGGGAAATGTTGCCAG -> GTGGGGAAATGTTGCCAGA
AGTGTACAGAATTCGCCAA -> GTGTACAGAATTCGCCAAA
AGTGTACTAAGCGATGATC -> GTGTACTAAGCGATGATCG
AGTGTATTCTTGTACTACC -> GTGTATTCTTGTACTACCG
AGTTAAGAGCAAGTCAAGC -> GTTAAGAGCAAGTCAAGCC
AGTTAAGAGCACCCTATAT -> GTTAAGAGCACCCTATATT
AGTTAAGAGCAGCTCCCGG -> GTTAAGAGCAGCTCCCGGC
AGTTAAGAGCATGGTTCCC -> GTTAAGAGCATGGTTCCCC
AGTTACGTCAGTAGGTAGT -> GTTACGTCAGTAGGTAGTC
AGTTAGATCGGTTTGGGGC -> GTTAGATCGGTTTGGGGCG
AGTTCACGACAAGCGTCTC -> GTTCACGACAAGCGTCTCA
AGTTCTGGGTTTGTAAGCC -> GTTCTGGGTTTGTAAGCCA
AGTTGAAACCGCCCGAGGG -> GTTGAAACCGCCCGAGGGG
AGTTGTACCGGAGTAGATA -> GTTGTACCGGAGTAGATAC
AGTTGTGCGAACTGCACCC -> GTTGTGCGAACTGCACCCC
AGTTTCGACGTGCTCGGAT -> GTTTCGACGTGCTCGGATG
ATAAAGCACGAGACATAAC -> TAAAGCACGAGACATAACT
ATAAATGGCTGTACGTTTT -> TAAATGGCTGTACGTTTTT
ATAACTAAAGTGTACTAAG -> TAACTAAAGTGTACTAAGC
ATAACTGATACCCAAAAAT -> TAACTGATACCCAAAAATG
ATAAGCCTCCTACAACACT -> TAAGCCTCCTACAACACTT
ATACACGGTTAGATGTGAT -> TACACGGTTAGATGTGATC
ATACCACCCTCCCTTCCAT -> TACCACCCTCCCTTCCATG
ATACCCAAAAATGGTTCGA -> TACCCAAAAATGGTTCGAC
ATACCCGTGCACACTACTG -> TACCCGTGCACACTACTGA
ATACGCAATAGCAGTTAGA -> TACGCAATAGCAGTTAGAT
ATACTGATCGATCGTCTAC -> TACTGATCGATCGTCTACA
ATACTGTCGGTATAGGTTG -> TACTGTCGGTATAGGTTGT
ATAGCAGTTAGATCGGTTT -> TAGCAGTTAGATCGGTTTG
ATAGCATTAATCGAGCTAG -> TAGCATTAATCGAGCTAGC
ATAGCGGGTCGAGTATAAA -> TAGCGGGTCGAGTATAAAT
ATAGGGTACCTTCTTTGCC -> TAGGGTACCTTCTTTGCCT
ATAGGTTGTACTAAGTATC -> TAGGTTGTACTAAGTATCA
ATAGTAGGGCCACCCCATC -> TAGTAGGGCCACCCCATCA
ATAGTATCATCCCTTTAAC -> TAGTATCATCCCTTTAACG
ATAGTATCGCGAACTAGCG -> TAGTATCGCGAACTAGCGG
ATATAGTATCATCCCTTTA -> TATAGTATCATCCCTTTAA
ATATGGCGTCTAAGGCCAC -> TATGGCGTCTAAGGCCACG
ATATGGTATTTTGCGAAGG -> TATGGTATTTTGCGAAGGG
ATATTAAGGTAAGCGAGGG -> TATTAAGGTAAGCGAGGGA
ATATTCATGTATTCTTGTA -> TATTCATGTATTCTTGTAC
ATCAAGCCGGCACAGAGTC -> TCAAGCCGGCACAGAGTCC
ATCAAGCGTAACCGGACCT -> TCAAGCGTAACCGGACCTT
ATCAAGTCAAACCAGGACC -> TCAAGTCAAACCAGGACCG
ATCAATTCACATTACAACG -> TCAATTCACATTACAACGC
ATCACAATGCAAGTCGATC -> TCACAATGCAAGTCGATCT
ATCAGAACCGTATATGGCG -> TCAGAACCGTATATGGCGT
ATCAGAGGATACCCGTGCA -> TCAGAGGATACCCGTGCAC
ATCAGCCGGTTGGCCAGGC -> TCAGCCGGTTGGCCAGGCG
ATCAGTTACGTCAGTAGGT -> TCAGTTACGTCAGTAGGTA
ATCATCCCTTTAACGGCTA -> TCATCCCTTTAACGGCTAC
ATCATCTTCATCTGGACCT -> TCATCTTCATCTGGACCTT
ATCCCACAGCCTGTTGGAT -> TCCCACAGCCTGTTGGATC
ATCCCTTTAACGGCTACAC -> TCCCTTTAACGGCTACACG
ATCCGGCTCACGTTACAGA -> TCCGGCTCACGTTACAGAG
ATCCGTGTAGTCGACAAGA -> TCCGTGTAGTCGACAAGAC
ATCCTACAAGAGTTAAGAG -> TCCTACAAGAGTTAAGAGC
ATCCTACCAGGAGTTTCGA -> TCCTACCAGGAGTTTCGAC
ATCCTGTGGCCTGTGGCGG -> TCCTGTGGCCTGTGGCGGG
ATCGAGCTAGCGGGCTAGT -> TCGAGCTAGCGGGCTAGTT
ATCGATCGTCTACAAGAGT -> TCGATCGTCTACAAGAGTT
ATCGCCGGAGAATGTGAAA -> TCGCCGGAGAATGTGAAAA
ATCGCCTGCCTCCCGTATC -> TCGCCTGCCTCCCGTATCT
ATCGCGAACTAGCGGCCTC -> TCGCGAACTAGCGGCCTCC
ATCGGTTTGGGGCGAAGGG -> TCGGTTTGGGGCGAAGGGT
ATCGTAGACGCGCACAGCA -> TCGTAGACGCGCACAGCAA
ATCGTATCTGATTTCCCCA -> TCGTATCTGATTTCCCCAG
ATCGTCGAGCTAAAGCCGC -> TCGTCGAGCTAAAGCCGCA
ATCGTCTACAAGAGTTAAG -> TCGTCTACAAGAGTTAAGA
ATCGTCTATCCTACAAGAG -> TCGTCTATCCTACAAGAGT
ATCGTTCCCAGCACGGATT -> TCGTTCCCAGCACGGATTT
ATCTAATCTGTTCGCGGAT -> TCTAATCTGTTCGCGGATG
ATCTACCGATCGCCTGCCT -> TCTACCGATCGCCTGCCTC
ATCTCGCGTTGCTTTTTAC -> TCTCGCGTTGCTTTTTACG
ATCTCTAGCTGCCTGACGA -> TCTCTAGCTGCCTGACGAC
ATCTGATTTCCCCAGGATA -> TCTGATTTCCCCAGGATAG
ATCTGCCTGATTAATTATT -> TCTGCCTGATTAATTATTA
ATCTGGACCTTATTATGCT -> TCTGGACCTTATTATGCTT
ATCTGGGCGAGGACATATT -> TCTGGGCGAGGACATATTA
ATCTGTTCGCGGATGTGTG -> TCTGTTCGCGGATGTGTGC
ATCTTCATCTGGACCTTAT -> TCTTCATCTGGACCTTATT
ATCTTCGTTCTAGTCTGGG -> TCTTCGTTCTAGTCTGGGG
ATCTTTGGCTGGTACATTG -> TCTTTGGCTGGTACATTGC
ATGAGATGGCCGCTGACCT -> TGAGATGGCCGCTGACCTA
ATGATCGTCGAGCTAAAGC -> TGATCGTCGAGCTAAAGCC
ATGCAAGTCGATCTGCCTG -> TGCAAGTCGATCTGCCTGA
ATGCGCGATCCTACCAGGA -> TGCGCGATCCTACCAGGAG
ATGCGTGTTCTGTGGTTCT -> TGCGTGTTCTGTGGTTCTC
ATGCTGCAGCCAACACTGT -> TGCTGCAGCCAACACTGTA
ATGCTGTGGTTAGGCCATA -> TGCTGTGGTTAGGCCATAA
ATGCTTGCTTATCTTTGGC -> TGCTTGCTTATCTTTGGCT
ATGGAGACTCAAACCATAG -> TGGAGACTCAAACCATAGT
ATGGCCGCTGACCTAGGTG -> TGGCCGCTGACCTAGGTGT
ATGGCCTTGCGAACAGAGA -> TGGCCTTGCGAACAGAGAA
ATGGCGTCTAAGGCCACGA -> TGGCGTCTAAGGCCACGAA
ATGGCTGTACGTTTTTGCT -> TGGCTGTACGTTTTTGCTG
ATGGTATTTTGCGAAGGGT -> TGGTATTTTGCGAAGGGTA
ATGGTTCCCCAGTGTATTC -> TGGTTCCCCAGTGTATTCT
ATGGTTCGACGCAAGTCGT -> TGGTTCGACGCAAGTCGTG
ATGTAAGCTCTCACTCTTC -> TGTAAGCTCTCACTCTTCG
ATGTACTAACTACAAGAGT -> TGTACTAACTACAAGAGTT
ATGTATTCTTGTACTACCG -> TGTATTCTTGTACTACCGC,TGTATTCTTGTACTACCGC
ATGTGAAAATGGAGACTCA -> TGTGAAAATGGAGACTCAA
ATGTGATCGTAGACGCGCA -> TGTGATCGTAGACGCGCAC
ATGTGCCCAACAAGAAGTC -> TGTGCCCAACAAGAAGTCG
ATGTGTGCGCATAGGGTAC -> TGTGTGCGCATAGGGTACC
ATGTTGCCAGAGAGAGTGC -> TGTTGCCAGAGAGAGTGCA
ATTAAACGATCATCTTCAT -> TTAAACGATCATCTTCATC
ATTAAACTATGCGCGATCC -> TTAAACTATGCGCGATCCT
ATTAAAGAAGTCCCGGACT -> TTAAAGAAGTCCCGGACTC
ATTAAGGTAAGCGAGGGAG -> TTAAGGTAAGCGAGGGAGC
ATTAATCGAGCTAGCGGGC -> TTAATCGAGCTAGCGGGCT
ATTAATTATTAAACTATGC -> TTAATTATTAAACTATGCG
ATTACAACGCTGAGGCTCC -> TTACAACGCTGAGGCTCCG
ATTATGCTTGCTTATCTTT -> TTATGCTTGCTTATCTTTG
ATTATTAAACTATGCGCGA -> TTATTAAACTATGCGCGAT
ATTCACATTACAACGCTGA -> TTCACATTACAACGCTGAG
ATTCATGTATTCTTGTACT -> TTCATGTATTCTTGTACTA
ATTCGATTGCAACGTACTC -> TTCGATTGCAACGTACTCA
ATTCGCCAAATTAAACGAT -> TTCGCCAAATTAAACGATC
ATTCGTGGTATACCACCCT -> TTCGTGGTATACCACCCTC
ATTCTTGTACTACCGCCGG -> TTCTTGTACTACCGCCGGA
ATTCTTGTACTACCGCGTA -> TTCTTGTACTACCGCGTAC
ATTCTTGTACTACCGCGTC -> TTCTTGTACTACCGCGTCA
ATTCTTGTACTACCGCTTA -> TTCTTGTACTACCGCTTAA
ATTCTTTAGTTGTGCGAAC -> TTCTTTAGTTGTGCGAACT
ATTGCAACGTACTCACGAT -> TTGCAACGTACTCACGATG
ATTGCCCTTCGTCCGCTCT -> TTGCCCTTCGTCCGCTCTG
ATTGGAGAGACAAGCCATA -> TTGGAGAGACAAGCCATAC
ATTGTATCCGTGTAGTCGA -> TTGTATCCGTGTAGTCGAC
ATTTAAAAGTGTACAGAAT -> TTTAAAAGTGTACAGAATT
ATTTAATCCGGCTCACGTT -> TTTAATCCGGCTCACGTTA
ATTTCAGGTTGCCTTGAGT -> TTTCAGGTTGCCTTGAGTT
ATTTCCCCAGGATAGCGGG -> TTTCCCCAGGATAGCGGGT
ATTTGCAACTTTTGTAACT -> TTTGCAACTTTTGTAACTG
ATTTGCAGGGAAAAAGAGA -> TTTGCAGGGAAAAAGAGAA
ATTTTGCGAAGGGTATGCG -> TTTTGCGAAGGGTATGCGT
CAAAAAGACACTTGCCCGC -> AAAAAGACACTTGCCCGCG
CAAAAATGGTTCGACGCAA -> AAAAATGGTTCGACGCAAG
CAAAATTTCAGGTTGCCTT -> AAAATTTCAGGTTGCCTTG
CAAACCAGGACCGTTATCA -> AAACCAGGACCGTTATCAG
CAAACCATAGTATCGCGAA -> AAACCATAGTATCGCGAAC
CAAACCGGTAGCCCAACAT -> AAACCGGTAGCCCAACATG
CAAAGCAAAATTTCAGGTT -> AAAGCAAAATTTCAGGTTG
CAAAGCGGGAGCCTGGTCT -> AAAGCGGGAGCCTGGTCTC
CAAAGGGAGCTACAAGAGT -> AAAGGGAGCTACAAGAGTT
CAAATTAAACGATCATCTT -> AAATTAAACGATCATCTTC
CAACAAGAAGTCGACGACG -> AACAAGAAGTCGACGACGT
CAACACAATTCGTGGTATA -> AACACAATTCGTGGTATAC
CAACACTGTATCTCTAGCT -> AACACTGTATCTCTAGCTG
CAACACTTCGCATAGTAGG -> AACACTTCGCATAGTAGGG
CAACATCAGCCGGTTGGCC -> AACATCAGCCGGTTGGCCA
CAACATGCTGTGGTTAGGC -> AACATGCTGTGGTTAGGCC
CAACCATACTGATCGATCG -> AACCATACTGATCGATCGT
CAACCCAACTGTCGCGTTC -> AACCCAACTGTCGCGTTCA
CAACGAGGAAGTACCTGCA -> AACGAGGAAGTACCTGCAT
CAACGCTGAGGCTCCGGAT -> AACGCTGAGGCTCCGGATC
CAACGTACTCACGATGTGC -> AACGTACTCACGATGTGCC
CAACTAACGGCCCAACCCA -> AACTAACGGCCCAACCCAA
CAACTGTCGCGTTCATCAA -> AACTGTCGCGTTCATCAAG
CAACTTTTGTAACTGTACA -> AACTTTTGTAACTGTACAA
CAAGAAGTCGACGACGTCT -> AAGAAGTCGACGACGTCTA
CAAGACACGATCGCCGGAG -> AAGACACGATCGCCGGAGA
CAAGAGTTAAGAGCAAGTC -> AAGAGTTAAGAGCAAGTCA
CAAGAGTTAAGAGCACCCT -> AAGAGTTAAGAGCACCCTA
CAAGAGTTAAGAGCAGCTC -> AAGAGTTAAGAGCAGCTCC
CAAGAGTTAAGAGCATGGT -> AAGAGTTAAGAGCATGGTT
CAAGCCATACACGGTTAGA -> AAGCCATACACGGTTAGAT
CAAGCCCATGTATTCTTGT -> AAGCCCATGTATTCTTGTA
CAAGCCGGCACAGAGTCCG -> AAGCCGGCACAGAGTCCGT
CAAGCGTAACCGGACCTTT -> AAGCGTAACCGGACCTTTG
CAAGCGTCTCAACATCAGC -> AAGCGTCTCAACATCAGCC
CAAGGAGCCTCAGCAGCCG -> AAGGAGCCTCAGCAGCCGA
CAAGTCAAACCAGGACCGT -> AAGTCAAACCAGGACCGTT
CAAGTCAAGCCCATGTATT -> AAGTCAAGCCCATGTATTC
CAAGTCGATCTGCCTGATT -> AAGTCGATCTGCCTGATTA
CAAGTCGATTTGCAACTTT -> AAGTCGATTTGCAACTTTT
CAAGTCGTGCCAGACAAAC -> AAGTCGTGCCAGACAAACC
CAATAGCAGTTAGATCGGT -> AATAGCAGTTAGATCGGTT
CAATCAAGCCGGCACAGAG -> AATCAAGCCGGCACAGAGT
CAATCGTATCTGATTTCCC -> AATCGTATCTGATTTCCCC
CAATCTGGGCGAGGACATA -> AATCTGGGCGAGGACATAT
CAATCTTCGTTCTAGTCTG -> AATCTTCGTTCTAGTCTGG
CAATGCAAGTCGATCTGCC -> AATGCAAGTCGATCTGCCT
CAATGCTGCAGCCAACACT -> AATGCTGCAGCCAACACTG
CAATTCACATTACAACGCT -> AATTCACATTACAACGCTG
CAATTCGTGGTATACCACC -> AATTCGTGGTATACCACCC
CAATTTAATCCGGCTCACG -> AATTTAATCCGGCTCACGT
CACAACCATACTGATCGAT -> ACAACCATACTGATCGATC
CACAATGCAAGTCGATCTG -> ACAATGCAAGTCGATCTGC
CACAATTCGTGGTATACCA -> ACAATTCGTGGTATACCAC
CACACTACTGAACAATTTA -> ACACTACTGAACAATTTAA
CACAGAGTCCGTGAGGCTA -> ACAGAGTCCGTGAGGCTAC
CACAGCAATCTGGGCGAGG -> ACAGCAATCTGGGCGAGGA
CACAGCCTGTTGGATCAGT -> ACAGCCTGTTGGATCAGTT
CACATGTACTAACTACAAG -> ACATGTACTAACTACAAGA
CACATTACAACGCTGAGGC -> ACATTACAACGCTGAGGCT
CACCCCATCAATTCACATT -> ACCCCATCAATTCACATTA
CACCCCCAAAGCAAAATTT -> ACCCCCAAAGCAAAATTTC
CACCCTATATTCATGTATT -> ACCCTATATTCATGTATTC
CACCCTCCCTTCCATGAGA -> ACCCTCCCTTCCATGAGAT
CACCGGTACACGTGCCCGT -> ACCGGTACACGTGCCCGTC
CACGAAAAGGCTAGCACGC -> ACGAAAAGGCTAGCACGCC
CACGACAAGCGTCTCAACA -> ACGACAAGCGTCTCAACAT
CACGACAGCACATGTACTA -> ACGACAGCACATGTACTAA
CACGAGACATAACTAAAGT -> ACGAGACATAACTAAAGTG
CACGATCGCCGGAGAATGT -> ACGATCGCCGGAGAATGTG
CACGATGTGCCCAACAAGA -> ACGATGTGCCCAACAAGAA
CACGCCTATTAAAGAAGTC -> ACGCCTATTAAAGAAGTCC
CACGGATTTAAAAGTGTAC -> ACGGATTTAAAAGTGTACA
CACGGTCACGACAGCACAT -> ACGGTCACGACAGCACATG
CACGGTTAGATGTGATCGT -> ACGGTTAGATGTGATCGTA
CACGTAAAGATTTGCAGGG -> ACGTAAAGATTTGCAGGGA
CACGTGCCCGTCGCTTCTT -> ACGTGCCCGTCGCTTCTTG
CACGTTACAGAGTCGGCAA -> ACGTTACAGAGTCGGCAAT
CACTACTGAACAATTTAAT -> ACTACTGAACAATTTAATC
CACTCTTCGGAGGAGGCAG -> ACTCTTCGGAGGAGGCAGA
CACTGTATCTCTAGCTGCC -> ACTGTATCTCTAGCTGCCT
CACTTAGAGCTGCTAATGT -> ACTTAGAGCTGCTAATGTA
CACTTCGCATAGTAGGGCC -> ACTTCGCATAGTAGGGCCA
CACTTGCCCGCGTTCAGAT -> ACTTGCCCGCGTTCAGATC
CAGAAAGTCAAAAAGACAC -> AGAAAGTCAAAAAGACACT
CAGAACCGTATATGGCGTC -> AGAACCGTATATGGCGTCT
CAGAATTCGCCAAATTAAA -> AGAATTCGCCAAATTAAAC
CAGACAAACCGGTAGCCCA -> AGACAAACCGGTAGCCCAA
CAGACTCGCGGAGTCGCTC -> AGACTCGCGGAGTCGCTCA
CAGAGAATTCGATTGCAAC -> AGAGAATTCGATTGCAACG
CAGAGAGAGTGCAACTAAC -> AGAGAGAGTGCAACTAACG
CAGAGGATACCCGTGCACA -> AGAGGATACCCGTGCACAC
CAGAGTCCGTGAGGCTACA -> AGAGTCCGTGAGGCTACAT
CAGAGTCGGCAATCAAGCC -> AGAGTCGGCAATCAAGCCG
CAGATCGTCTATCCTACAA -> AGATCGTCTATCCTACAAG
CAGCAATCTGGGCGAGGAC -> AGCAATCTGGGCGAGGACA
CAGCACATGTACTAACTAC -> AGCACATGTACTAACTACA
CAGCACGGATTTAAAAGTG -> AGCACGGATTTAAAAGTGT
CAGCAGCCGAGGCATCCTG -> AGCAGCCGAGGCATCCTGT
CAGCCAACACTGTATCTCT -> AGCCAACACTGTATCTCTA
CAGCCGAGGCATCCTGTGG -> AGCCGAGGCATCCTGTGGC
CAGCCGGTTGGCCAGGCGG -> AGCCGGTTGGCCAGGCGGC
CAGCCTGTTGGATCAGTTA -> AGCCTGTTGGATCAGTTAC
CAGCGGGCCGGGCTGGGTG -> AGCGGGCCGGGCTGGGTGG
CAGCTCCCGGCCCTGTATT -> AGCTCCCGGCCCTGTATTC
CAGGACCGTTATCAGAGGA -> AGGACCGTTATCAGAGGAT
CAGGAGTTTCGACGTGCTC -> AGGAGTTTCGACGTGCTCG
CAGGATAGCGGGTCGAGTA -> AGGATAGCGGGTCGAGTAT
CAGGCGGCGAACGATAAGC -> AGGCGGCGAACGATAAGCC
CAGGGAAAAAGAGAAACTA -> AGGGAAAAAGAGAAACTAG
CAGGTTGCCTTGAGTTGAA -> AGGTTGCCTTGAGTTGAAA
CAGTAGGTAGTCCATCGTT -> AGTAGGTAGTCCATCGTTC
CAGTCCAAAGGGAGCTACA -> AGTCCAAAGGGAGCTACAA
CAGTGTATTCTTGTACTAC -> AGTGTATTCTTGTACTACC
CAGTTACGTCAGTAGGTAG -> AGTTACGTCAGTAGGTAGT
CAGTTAGATCGGTTTGGGG -> AGTTAGATCGGTTTGGGGC
CAGTTCACGACAAGCGTCT -> AGTTCACGACAAGCGTCTC
CATAAAGCACGAGACATAA -> ATAAAGCACGAGACATAAC
CATAACTAAAGTGTACTAA -> ATAACTAAAGTGTACTAAG
CATAACTGATACCCAAAAA -> ATAACTGATACCCAAAAAT
CATACACGGTTAGATGTGA -> ATACACGGTTAGATGTGAT
CATACTGATCGATCGTCTA -> ATACTGATCGATCGTCTAC
CATAGGGTACCTTCTTTGC -> ATAGGGTACCTTCTTTGCC
CATAGTAGGGCCACCCCAT -> ATAGTAGGGCCACCCCATC
CATAGTATCGCGAACTAGC -> ATAGTATCGCGAACTAGCG
CATATGGTATTTTGCGAAG -> ATATGGTATTTTGCGAAGG
CATATTAAGGTAAGCGAGG -> ATATTAAGGTAAGCGAGGG
CATCAAGCGTAACCGGACC -> ATCAAGCGTAACCGGACCT
CATCAAGTCAAACCAGGAC -> ATCAAGTCAAACCAGGACC
CATCAATTCACATTACAAC -> ATCAATTCACATTACAACG
CATCACAATGCAAGTCGAT -> ATCACAATGCAAGTCGATC
CATCAGCCGGTTGGCCAGG -> ATCAGCCGGTTGGCCAGGC
CATCCCTTTAACGGCTACA -> ATCCCTTTAACGGCTACAC
CATCCTGTGGCCTGTGGCG -> ATCCTGTGGCCTGTGGCGG
CATCGTTCCCAGCACGGAT -> ATCGTTCCCAGCACGGATT
CATCTAATCTGTTCGCGGA -> ATCTAATCTGTTCGCGGAT
CATCTACCGATCGCCTGCC -> ATCTACCGATCGCCTGCCT
CATCTGGACCTTATTATGC -> ATCTGGACCTTATTATGCT
CATCTTCATCTGGACCTTA -> ATCTTCATCTGGACCTTAT
CATGAGATGGCCGCTGACC -> ATGAGATGGCCGCTGACCT
CATGCTGTGGTTAGGCCAT -> ATGCTGTGGTTAGGCCATA
CATGGTTCCCCAGTGTATT -> ATGGTTCCCCAGTGTATTC
CATGTACTAACTACAAGAG -> ATGTACTAACTACAAGAGT
CATGTATTCTTGTACTACC -> ATGTATTCTTGTACTACCG,ATGTATTCTTGTACTACCG
CATTAATCGAGCTAGCGGG -> ATTAATCGAGCTAGCGGGC
CATTACAACGCTGAGGCTC -> ATTACAACGCTGAGGCTCC
CATTCTTTAGTTGTGCGAA -> ATTCTTTAGTTGTGCGAAC
CATTGCCCTTCGTCCGCTC -> ATTGCCCTTCGTCCGCTCT
CATTGGAGAGACAAGCCAT -> ATTGGAGAGACAAGCCATA
CCAAAAATGGTTCGACGCA -> CAAAAATGGTTCGACGCAA
CCAAAGCAAAATTTCAGGT -> CAAAGCAAAATTTCAGGTT
CCAAAGGGAGCTACAAGAG -> CAAAGGGAGCTACAAGAGT
CCAAATTAAACGATCATCT -> CAAATTAAACGATCATCTT
CCAACAAGAAGTCGACGAC -> CAACAAGAAGTCGACGACG
CCAACACAATTCGTGGTAT -> CAACACAATTCGTGGTATA
CCAACACTGTATCTCTAGC -> CAACACTGTATCTCTAGCT
CCAACATGCTGTGGTTAGG -> CAACATGCTGTGGTTAGGC
CCAACCCAACTGTCGCGTT -> CAACCCAACTGTCGCGTTC
CCAACTGTCGCGTTCATCA -> CAACTGTCGCGTTCATCAA
CCAAGTCGATTTGCAACTT -> CAAGTCGATTTGCAACTTT
CCACAGCCTGTTGGATCAG -> CACAGCCTGTTGGATCAGT
CCACCCCATCAATTCACAT -> CACCCCATCAATTCACATT
CCACCCTCCCTTCCATGAG -> CACCCTCCCTTCCATGAGA
CCACCGGTACACGTGCCCG -> CACCGGTACACGTGCCCGT
CCACGAAAAGGCTAGCACG -> CACGAAAAGGCTAGCACGC
CCAGACAAACCGGTAGCCC -> CAGACAAACCGGTAGCCCA
CCAGAGAGAGTGCAACTAA -> CAGAGAGAGTGCAACTAAC
CCAGCACGGATTTAAAAGT -> CAGCACGGATTTAAAAGTG
CCAGCGGGCCGGGCTGGGT -> CAGCGGGCCGGGCTGGGTG
CCAGGACCGTTATCAGAGG -> CAGGACCGTTATCAGAGGA
CCAGGAGTTTCGACGTGCT -> CAGGAGTTTCGACGTGCTC
CCAGGATAGCGGGTCGAGT -> CAGGATAGCGGGTCGAGTA
CCAGGCGGCGAACGATAAG -> CAGGCGGCGAACGATAAGC
CCAGTGTATTCTTGTACTA -> CAGTGTATTCTTGTACTAC
CCATAAAGCACGAGACATA -> CATAAAGCACGAGACATAA
CCATACACGGTTAGATGTG -> CATACACGGTTAGATGTGA
CCATACTGATCGATCGTCT -> CATACTGATCGATCGTCTA
CCATAGTATCGCGAACTAG -> CATAGTATCGCGAACTAGC
CCATATGGTATTTTGCGAA -> CATATGGTATTTTGCGAAG
CCATCAATTCACATTACAA -> CATCAATTCACATTACAAC
CCATCGTTCCCAGCACGGA -> CATCGTTCCCAGCACGGAT
CCATGAGATGGCCGCTGAC -> CATGAGATGGCCGCTGACC
CCATGTATTCTTGTACTAC -> CATGTATTCTTGTACTACC
CCCAAAAATGGTTCGACGC -> CCAAAAATGGTTCGACGCA
CCCAAAGCAAAATTTCAGG -> CCAAAGCAAAATTTCAGGT
CCCAACAAGAAGTCGACGA -> CCAACAAGAAGTCGACGAC
CCCAACATGCTGTGGTTAG -> CCAACATGCTGTGGTTAGG
CCCAACCCAACTGTCGCGT -> CCAACCCAACTGTCGCGTT
CCCAACTGTCGCGTTCATC -> CCAACTGTCGCGTTCATCA
CCCACAGCCTGTTGGATCA -> CCACAGCCTGTTGGATCAG
CCCAGCACGGATTTAAAAG -> CCAGCACGGATTTAAAAGT
CCCAGGATAGCGGGTCGAG -> CCAGGATAGCGGGTCGAGT
CCCAGTGTATTCTTGTACT -> CCAGTGTATTCTTGTACTA
CCCATCAATTCACATTACA -> CCATCAATTCACATTACAA
CCCATGTATTCTTGTACTA -> CCATGTATTCTTGTACTAC
CCCCAAAGCAAAATTTCAG -> CCCAAAGCAAAATTTCAGG
CCCCAGGATAGCGGGTCGA -> CCCAGGATAGCGGGTCGAG
CCCCAGTGTATTCTTGTAC -> CCCAGTGTATTCTTGTACT
CCCCATCAATTCACATTAC -> CCCATCAATTCACATTACA
CCCCCAAAGCAAAATTTCA -> CCCCAAAGCAAAATTTCAG
CCCGAGGGGTTCATCTAAT -> CCGAGGGGTTCATCTAATC
CCCGCGTTCAGATCGTCTA -> CCGCGTTCAGATCGTCTAT
CCCGGACTCATTGGAGAGA -> CCGGACTCATTGGAGAGAC
CCCGGCCCTGTATTCTTGT -> CCGGCCCTGTATTCTTGTA
CCCGTATCTCGCGTTGCTT -> CCGTATCTCGCGTTGCTTT
CCCGTCGCTTCTTGAATTG -> CCGTCGCTTCTTGAATTGT
CCCGTGCACACTACTGAAC -> CCGTGCACACTACTGAACA
CCCTATATTCATGTATTCT -> CCTATATTCATGTATTCTT
CCCTCCCTTCCATGAGATG -> CCTCCCTTCCATGAGATGG
CCCTGCTTGGTCTAAGTTG -> CCTGCTTGGTCTAAGTTGT
CCCTGTATTCTTGTACTAC -> CCTGTATTCTTGTACTACC
CCCTTCCATGAGATGGCCG -> CCTTCCATGAGATGGCCGC
CCCTTCGTCCGCTCTGTTC -> CCTTCGTCCGCTCTGTTCA
CCCTTTAACGGCTACACGG -> CCTTTAACGGCTACACGGT
CCGAGGCATCCTGTGGCCT -> CGAGGCATCCTGTGGCCTG
CCGAGGGGTTCATCTAATC -> CGAGGGGTTCATCTAATCT
CCGATCGCCTGCCTCCCGT -> CGATCGCCTGCCTCCCGTA
CCGCAACGAGGAAGTACCT -> CGCAACGAGGAAGTACCTG
CCGCCCGAGGGGTTCATCT -> CGCCCGAGGGGTTCATCTA
CCGCCCTGCTTGGTCTAAG -> CGCCCTGCTTGGTCTAAGT
CCGCCGGACACAACCATAC -> CGCCGGACACAACCATACT
CCGCGTACCATATGGTATT -> CGCGTACCATATGGTATTT
CCGCGTCAGTTCACGACAA -> CGCGTCAGTTCACGACAAG
CCGCGTTATACGCAATAGC -> CGCGTTATACGCAATAGCA
CCGCGTTCAGATCGTCTAT -> CGCGTTCAGATCGTCTATC
CCGCTCTGTTCAATGCTGC -> CGCTCTGTTCAATGCTGCA
CCGCTGACCTAGGTGTGGT -> CGCTGACCTAGGTGTGGTT
CCGCTTAAGATATAGTATC -> CGCTTAAGATATAGTATCA
CCGGACACAACCATACTGA -> CGGACACAACCATACTGAT
CCGGACCTTTGGACCAACA -> CGGACCTTTGGACCAACAC
CCGGACTCATTGGAGAGAC -> CGGACTCATTGGAGAGACA
CCGGAGAATGTGAAAATGG -> CGGAGAATGTGAAAATGGA
CCGGAGTAGATACTGTCGG -> CGGAGTAGATACTGTCGGT
CCGGATCCCACAGCCTGTT -> CGGATCCCACAGCCTGTTG
CCGGCACAGAGTCCGTGAG -> CGGCACAGAGTCCGTGAGG
CCGGCCCTGTATTCTTGTA -> CGGCCCTGTATTCTTGTAC
CCGGCTCACGTTACAGAGT -> CGGCTCACGTTACAGAGTC
CCGGGCTGGGTGGTATGGC -> CGGGCTGGGTGGTATGGCC
CCGGTACACGTGCCCGTCG -> CGGTACACGTGCCCGTCGC
CCGGTAGCCCAACATGCTG -> CGGTAGCCCAACATGCTGT
CCGGTTGGCCAGGCGGCGA -> CGGTTGGCCAGGCGGCGAA
CCGTATATGGCGTCTAAGG -> CGTATATGGCGTCTAAGGC
CCGTATCTCGCGTTGCTTT -> CGTATCTCGCGTTGCTTTT
CCGTCGCTTCTTGAATTGT -> CGTCGCTTCTTGAATTGTA
CCGTGAGGCTACATCTACC -> CGTGAGGCTACATCTACCG
CCGTGCACACTACTGAACA -> CGTGCACACTACTGAACAA
CCGTGTAGTCGACAAGACA -> CGTGTAGTCGACAAGACAC
CCGTTATCAGAGGATACCC -> CGTTATCAGAGGATACCCG
CCTACAACACTTCGCATAG -> CTACAACACTTCGCATAGT
CCTACAAGAGTTAAGAGCA -> CTACAAGAGTTAAGAGCAC
CCTACCAGGAGTTTCGACG -> CTACCAGGAGTTTCGACGT
CCTAGGTGTGGTTTCTGCT -> CTAGGTGTGGTTTCTGCTT
CCTATATTCATGTATTCTT -> CTATATTCATGTATTCTTG
CCTATTAAAGAAGTCCCGG -> CTATTAAAGAAGTCCCGGA
CCTCAGCAGCCGAGGCATC -> CTCAGCAGCCGAGGCATCC
CCTCCCGTATCTCGCGTTG -> CTCCCGTATCTCGCGTTGC
CCTCCCTTCCATGAGATGG -> CTCCCTTCCATGAGATGGC
CCTCCGCCCTGCTTGGTCT -> CTCCGCCCTGCTTGGTCTA
CCTCCTACAACACTTCGCA -> CTCCTACAACACTTCGCAT
CCTGACGACAAGGAGCCTC -> CTGACGACAAGGAGCCTCA
CCTGATTAATTATTAAACT -> CTGATTAATTATTAAACTA
CCTGCATTCTTTAGTTGTG -> CTGCATTCTTTAGTTGTGC
CCTGCCTCCCGTATCTCGC -> CTGCCTCCCGTATCTCGCG
CCTGCTTGGTCTAAGTTGT -> CTGCTTGGTCTAAGTTGTA
CCTGGTAAGAGTGGGGAAA -> CTGGTAAGAGTGGGGAAAT
CCTGGTCTCTCGAGTGCCG -> CTGGTCTCTCGAGTGCCGC
CCTGTATTCTTGTACTACC -> CTGTATTCTTGTACTACCG
CCTGTGGCCTGTGGCGGGC -> CTGTGGCCTGTGGCGGGCA
CCTGTGGCGGGCAGAAAGT -> CTGTGGCGGGCAGAAAGTC
CCTGTTGGATCAGTTACGT -> CTGTTGGATCAGTTACGTC
CCTTATTATGCTTGCTTAT -> CTTATTATGCTTGCTTATC
CCTTCCATGAGATGGCCGC -> CTTCCATGAGATGGCCGCT
CCTTCGTCCGCTCTGTTCA -> CTTCGTCCGCTCTGTTCAA
CCTTCTTTGCCTGGTAAGA -> CTTCTTTGCCTGGTAAGAG
CCTTGAGTTGAAACCGCCC -> CTTGAGTTGAAACCGCCCG
CCTTGCGAACAGAGAATTC -> CTTGCGAACAGAGAATTCG
CCTTTAACGGCTACACGGT -> CTTTAACGGCTACACGGTC
CCTTTGGACCAACACAATT -> CTTTGGACCAACACAATTC
CGAAAAGGCTAGCACGCCT -> GAAAAGGCTAGCACGCCTA
CGAACAGAGAATTCGATTG -> GAACAGAGAATTCGATTGC
CGAACGATAAGCCTCCTAC -> GAACGATAAGCCTCCTACA
CGAACTAGCGGCCTCCGCC -> GAACTAGCGGCCTCCGCCC
CGAACTGCACCCCCAAAGC -> GAACTGCACCCCCAAAGCA
CGAAGGGTATGCGTGTTCT -> GAAGGGTATGCGTGTTCTG
CGAAGGGTCGCTGCACTTA -> GAAGGGTCGCTGCACTTAG
CGACAAGACACGATCGCCG -> GACAAGACACGATCGCCGG
CGACAAGCGTCTCAACATC -> GACAAGCGTCTCAACATCA
CGACAAGGAGCCTCAGCAG -> GACAAGGAGCCTCAGCAGC
CGACAGCACATGTACTAAC -> GACAGCACATGTACTAACT
CGACATCACAATGCAAGTC -> GACATCACAATGCAAGTCG
CGACGACGTCTAAGCAGTC -> GACGACGTCTAAGCAGTCC
CGACGCAAGTCGTGCCAGA -> GACGCAAGTCGTGCCAGAC
CGACGTCTAAGCAGTCCAA -> GACGTCTAAGCAGTCCAAA
CGACGTGCTCGGATGGACT -> GACGTGCTCGGATGGACTG
CGAGACATAACTAAAGTGT -> GAGACATAACTAAAGTGTA
CGAGCTAAAGCCGCAACGA -> GAGCTAAAGCCGCAACGAG
CGAGCTAGCGGGCTAGTTC -> GAGCTAGCGGGCTAGTTCT
CGAGGAAGTACCTGCATTC -> GAGGAAGTACCTGCATTCT
CGAGGACATATTAAGGTAA -> GAGGACATATTAAGGTAAG
CGAGGCATCCTGTGGCCTG -> GAGGCATCCTGTGGCCTGT
CGAGGGAGCAATCGTATCT -> GAGGGAGCAATCGTATCTG
CGAGGGGTTCATCTAATCT -> GAGGGGTTCATCTAATCTG
CGAGTATAAATGGCTGTAC -> GAGTATAAATGGCTGTACG
CGAGTGCCGCGTTATACGC -> GAGTGCCGCGTTATACGCA
CGATAAGCCTCCTACAACA -> GATAAGCCTCCTACAACAC
CGATCATCTTCATCTGGAC -> GATCATCTTCATCTGGACC
CGATCCTACCAGGAGTTTC -> GATCCTACCAGGAGTTTCG
CGATCGCCGGAGAATGTGA -> GATCGCCGGAGAATGTGAA
CGATCGCCTGCCTCCCGTA -> GATCGCCTGCCTCCCGTAT
CGATCGTCTACAAGAGTTA -> GATCGTCTACAAGAGTTAA
CGATCTGCCTGATTAATTA -> GATCTGCCTGATTAATTAT
CGATGATCGTCGAGCTAAA -> GATGATCGTCGAGCTAAAG
CGATGTGCCCAACAAGAAG -> GATGTGCCCAACAAGAAGT
CGATTGCAACGTACTCACG -> GATTGCAACGTACTCACGA
CGATTTGCAACTTTTGTAA -> GATTTGCAACTTTTGTAAC
CGCAACGAGGAAGTACCTG -> GCAACGAGGAAGTACCTGC
CGCAAGTCGTGCCAGACAA -> GCAAGTCGTGCCAGACAAA
CGCAATAGCAGTTAGATCG -> GCAATAGCAGTTAGATCGG
CGCACAGCAATCTGGGCGA -> GCACAGCAATCTGGGCGAG
CGCACGTAAAGATTTGCAG -> GCACGTAAAGATTTGCAGG
CGCATAGGGTACCTTCTTT -> GCATAGGGTACCTTCTTTG
CGCATAGTAGGGCCACCCC -> GCATAGTAGGGCCACCCCA
CGCCAAATTAAACGATCAT -> GCCAAATTAAACGATCATC
CGCCCGAGGGGTTCATCTA -> GCCCGAGGGGTTCATCTAA
CGCCCTGCTTGGTCTAAGT -> GCCCTGCTTGGTCTAAGTT
CGCCGGACACAACCATACT -> GCCGGACACAACCATACTG
CGCCGGAGAATGTGAAAAT -> GCCGGAGAATGTGAAAATG
CGCCTATTAAAGAAGTCCC -> GCCTATTAAAGAAGTCCCG
CGCCTGCCTCCCGTATCTC -> GCCTGCCTCCCGTATCTCG
CGCGAACTAGCGGCCTCCG -> GCGAACTAGCGGCCTCCGC
CGCGATCCTACCAGGAGTT -> GCGATCCTACCAGGAGTTT
CGCGCACAGCAATCTGGGC -> GCGCACAGCAATCTGGGCG
CGCGGAGTCGCTCATAACT -> GCGGAGTCGCTCATAACTG
CGCGGATGTGTGCGCATAG -> GCGGATGTGTGCGCATAGG
CGCGTACCATATGGTATTT -> GCGTACCATATGGTATTTT
CGCGTCAGTTCACGACAAG -> GCGTCAGTTCACGACAAGC
CGCGTTATACGCAATAGCA -> GCGTTATACGCAATAGCAG
CGCGTTCAGATCGTCTATC -> GCGTTCAGATCGTCTATCC
CGCGTTCATCAAGTCAAAC -> GCGTTCATCAAGTCAAACC
CGCGTTGCTTTTTACGGGT -> GCGTTGCTTTTTACGGGTG
CGCTCATAACTGATACCCA -> GCTCATAACTGATACCCAA
CGCTCTGTTCAATGCTGCA -> GCTCTGTTCAATGCTGCAG
CGCTGACCTAGGTGTGGTT -> GCTGACCTAGGTGTGGTTT
CGCTGAGGCTCCGGATCCC -> GCTGAGGCTCCGGATCCCA
CGCTGCACTTAGAGCTGCT -> GCTGCACTTAGAGCTGCTA
CGCTTAAGATATAGTATCA -> GCTTAAGATATAGTATCAT
CGCTTCTTGAATTGTATCC -> GCTTCTTGAATTGTATCCG
CGGACACAACCATACTGAT -> GGACACAACCATACTGATC
CGGACCTTTGGACCAACAC -> GGACCTTTGGACCAACACA
CGGACTCATTGGAGAGACA -> GGACTCATTGGAGAGACAA
CGGAGAATGTGAAAATGGA -> GGAGAATGTGAAAATGGAG
CGGAGGAGGCAGACTCGCG -> GGAGGAGGCAGACTCGCGG
CGGAGTAGATACTGTCGGT -> GGAGTAGATACTGTCGGTA
CGGAGTCGCTCATAACTGA -> GGAGTCGCTCATAACTGAT
CGGATCCCACAGCCTGTTG -> GGATCCCACAGCCTGTTGG
CGGATGGACTGGTGCGATT -> GGATGGACTGGTGCGATTG
CGGATGTGTGCGCATAGGG -> GGATGTGTGCGCATAGGGT
CGGATTTAAAAGTGTACAG -> GGATTTAAAAGTGTACAGA
CGGCAATCAAGCCGGCACA -> GGCAATCAAGCCGGCACAG
CGGCACAGAGTCCGTGAGG -> GGCACAGAGTCCGTGAGGC
CGGCCCAACCCAACTGTCG -> GGCCCAACCCAACTGTCGC
CGGCCCTGTATTCTTGTAC -> GGCCCTGTATTCTTGTACT
CGGCCTCCGCCCTGCTTGG -> GGCCTCCGCCCTGCTTGGT
CGGCGAACGATAAGCCTCC -> GGCGAACGATAAGCCTCCT
CGGCTACACGGTCACGACA -> GGCTACACGGTCACGACAG
CGGCTCACGTTACAGAGTC -> GGCTCACGTTACAGAGTCG
CGGGAGCCTGGTCTCTCGA -> GGGAGCCTGGTCTCTCGAG
CGGGCAGAAAGTCAAAAAG -> GGGCAGAAAGTCAAAAAGA
CGGGCCGGGCTGGGTGGTA -> GGGCCGGGCTGGGTGGTAT
CGGGCTAGTTCTGGGTTTG -> GGGCTAGTTCTGGGTTTGT
CGGGCTGGGTGGTATGGCC -> GGGCTGGGTGGTATGGCCT
CGGGTCGAGTATAAATGGC -> GGGTCGAGTATAAATGGCT
CGGGTGAGCCAGCGGGCCG -> GGGTGAGCCAGCGGGCCGG
CGGTACACGTGCCCGTCGC -> GGTACACGTGCCCGTCGCT
CGGTAGCCCAACATGCTGT -> GGTAGCCCAACATGCTGTG
CGGTATAGGTTGTACTAAG -> GGTATAGGTTGTACTAAGT
CGGTCACGACAGCACATGT -> GGTCACGACAGCACATGTA
CGGTTAGATGTGATCGTAG -> GGTTAGATGTGATCGTAGA
CGGTTGGCCAGGCGGCGAA -> GGTTGGCCAGGCGGCGAAC
CGGTTTGGGGCGAAGGGTC -> GGTTTGGGGCGAAGGGTCG
CGTAAAGATTTGCAGGGAA -> GTAAAGATTTGCAGGGAAA
CGTAACCGGACCTTTGGAC -> GTAACCGGACCTTTGGACC
CGTACCATATGGTATTTTG -> GTACCATATGGTATTTTGC
CGTACTCACGATGTGCCCA -> GTACTCACGATGTGCCCAA
CGTAGACGCGCACAGCAAT -> GTAGACGCGCACAGCAATC
CGTATATGGCGTCTAAGGC -> GTATATGGCGTCTAAGGCC
CGTATCTCGCGTTGCTTTT -> GTATCTCGCGTTGCTTTTT
CGTATCTGATTTCCCCAGG -> GTATCTGATTTCCCCAGGA
CGTCAGTAGGTAGTCCATC -> GTCAGTAGGTAGTCCATCG
CGTCAGTTCACGACAAGCG -> GTCAGTTCACGACAAGCGT
CGTCCGCTCTGTTCAATGC -> GTCCGCTCTGTTCAATGCT
CGTCGAGCTAAAGCCGCAA -> GTCGAGCTAAAGCCGCAAC
CGTCGCTTCTTGAATTGTA -> GTCGCTTCTTGAATTGTAT
CGTCTAAGCAGTCCAAAGG -> GTCTAAGCAGTCCAAAGGG
CGTCTAAGGCCACGAAAAG -> GTCTAAGGCCACGAAAAGG
CGTCTACAAGAGTTAAGAG -> GTCTACAAGAGTTAAGAGC
CGTCTATCCTACAAGAGTT -> GTCTATCCTACAAGAGTTA
CGTCTCAACATCAGCCGGT -> GTCTCAACATCAGCCGGTT
CGTGAGGCTACATCTACCG -> GTGAGGCTACATCTACCGA
CGTGCACACTACTGAACAA -> GTGCACACTACTGAACAAT
CGTGCCAGACAAACCGGTA -> GTGCCAGACAAACCGGTAG
CGTGCCCGTCGCTTCTTGA -> GTGCCCGTCGCTTCTTGAA
CGTGCTCGGATGGACTGGT -> GTGCTCGGATGGACTGGTG
CGTGGTATACCACCCTCCC -> GTGGTATACCACCCTCCCT
CGTGTAGTCGACAAGACAC -> GTGTAGTCGACAAGACACG
CGTGTTCTGTGGTTCTCCA -> GTGTTCTGTGGTTCTCCAA
CGTTACAGAGTCGGCAATC -> GTTACAGAGTCGGCAATCA
CGTTATACGCAATAGCAGT -> GTTATACGCAATAGCAGTT
CGTTATCAGAGGATACCCG -> GTTATCAGAGGATACCCGT
CGTTCAGATCGTCTATCCT -> GTTCAGATCGTCTATCCTA
CGTTCATCAAGTCAAACCA -> GTTCATCAAGTCAAACCAG
CGTTCCCAGCACGGATTTA -> GTTCCCAGCACGGATTTAA
CGTTCTAGTCTGGGGATAG -> GTTCTAGTCTGGGGATAGC
CGTTGCTTTTTACGGGTGA -> GTTGCTTTTTACGGGTGAG
CGTTTTTGCTGTCTGGGAG -> GTTTTTGCTGTCTGGGAGC
CTAAAGCCGCAACGAGGAA -> TAAAGCCGCAACGAGGAAG
CTAAAGTGTACTAAGCGAT -> TAAAGTGTACTAAGCGATG
CTAACGGCCCAACCCAACT -> TAACGGCCCAACCCAACTG
CTAACTACAAGAGTTAAGA -> TAACTACAAGAGTTAAGAG
CTAAGCAGTCCAAAGGGAG -> TAAGCAGTCCAAAGGGAGC
CTAAGCGATGATCGTCGAG -> TAAGCGATGATCGTCGAGC
CTAAGGCCACGAAAAGGCT -> TAAGGCCACGAAAAGGCTA
CTAAGTATCAGAACCGTAT -> TAAGTATCAGAACCGTATA
CTAAGTTGTACCGGAGTAG -> TAAGTTGTACCGGAGTAGA
CTAATCTGTTCGCGGATGT -> TAATCTGTTCGCGGATGTG
CTAATGTAAGCTCTCACTC -> TAATGTAAGCTCTCACTCT
CTACAACACTTCGCATAGT -> TACAACACTTCGCATAGTA
CTACAAGAGTTAAGAGCAA -> TACAAGAGTTAAGAGCAAG
CTACAAGAGTTAAGAGCAC -> TACAAGAGTTAAGAGCACC
CTACAAGAGTTAAGAGCAG -> TACAAGAGTTAAGAGCAGC
CTACAAGAGTTAAGAGCAT -> TACAAGAGTTAAGAGCATG
CTACACGGTCACGACAGCA -> TACACGGTCACGACAGCAC
CTACATCTACCGATCGCCT -> TACATCTACCGATCGCCTG
CTACCAGGAGTTTCGACGT -> TACCAGGAGTTTCGACGTG
CTACCGATCGCCTGCCTCC -> TACCGATCGCCTGCCTCCC
CTACCGCCGGACACAACCA -> TACCGCCGGACACAACCAT
CTACCGCGTACCATATGGT -> TACCGCGTACCATATGGTA
CTACCGCGTCAGTTCACGA -> TACCGCGTCAGTTCACGAC
CTACCGCTTAAGATATAGT -> TACCGCTTAAGATATAGTA
CTACTGAACAATTTAATCC -> TACTGAACAATTTAATCCG
CTAGCACGCCTATTAAAGA -> TAGCACGCCTATTAAAGAA
CTAGCGACATCACAATGCA -> TAGCGACATCACAATGCAA
CTAGCGGCCTCCGCCCTGC -> TAGCGGCCTCCGCCCTGCT
CTAGCGGGCTAGTTCTGGG -> TAGCGGGCTAGTTCTGGGT
CTAGCTGCCTGACGACAAG -> TAGCTGCCTGACGACAAGG
CTAGGTGTGGTTTCTGCTT -> TAGGTGTGGTTTCTGCTTC
CTAGTCTGGGGATAGCATT -> TAGTCTGGGGATAGCATTA
CTAGTTCTGGGTTTGTAAG -> TAGTTCTGGGTTTGTAAGC
CTATATTCATGTATTCTTG -> TATATTCATGTATTCTTGT
CTATCCTACAAGAGTTAAG -> TATCCTACAAGAGTTAAGA
CTATGCGCGATCCTACCAG -> TATGCGCGATCCTACCAGG
CTATTAAAGAAGTCCCGGA -> TATTAAAGAAGTCCCGGAC
CTCAAACCATAGTATCGCG -> TCAAACCATAGTATCGCGA
CTCAACATCAGCCGGTTGG -> TCAACATCAGCCGGTTGGC
CTCACGATGTGCCCAACAA -> TCACGATGTGCCCAACAAG
CTCACGTTACAGAGTCGGC -> TCACGTTACAGAGTCGGCA
CTCACTCTTCGGAGGAGGC -> TCACTCTTCGGAGGAGGCA
CTCAGCAGCCGAGGCATCC -> TCAGCAGCCGAGGCATCCT
CTCATAACTGATACCCAAA -> TCATAACTGATACCCAAAA
CTCATTGGAGAGACAAGCC -> TCATTGGAGAGACAAGCCA
CTCCAAGTCGATTTGCAAC -> TCCAAGTCGATTTGCAACT
CTCCCGGCCCTGTATTCTT -> TCCCGGCCCTGTATTCTTG
CTCCCGTATCTCGCGTTGC -> TCCCGTATCTCGCGTTGCT
CTCCCTTCCATGAGATGGC -> TCCCTTCCATGAGATGGCC
CTCCGCCCTGCTTGGTCTA -> TCCGCCCTGCTTGGTCTAA
CTCCGGATCCCACAGCCTG -> TCCGGATCCCACAGCCTGT
CTCCTACAACACTTCGCAT -> TCCTACAACACTTCGCATA
CTCGAGTGCCGCGTTATAC -> TCGAGTGCCGCGTTATACG
CTCGCGGAGTCGCTCATAA -> TCGCGGAGTCGCTCATAAC
CTCGCGTTGCTTTTTACGG -> TCGCGTTGCTTTTTACGGG
CTCGGATGGACTGGTGCGA -> TCGGATGGACTGGTGCGAT
CTCTAGCTGCCTGACGACA -> TCTAGCTGCCTGACGACAA
CTCTCACTCTTCGGAGGAG -> TCTCACTCTTCGGAGGAGG
CTCTCGAGTGCCGCGTTAT -> TCTCGAGTGCCGCGTTATA
CTCTGTTCAATGCTGCAGC -> TCTGTTCAATGCTGCAGCC
CTCTTCGGAGGAGGCAGAC -> TCTTCGGAGGAGGCAGACT
CTGAACAATTTAATCCGGC -> TGAACAATTTAATCCGGCT
CTGACCTAGGTGTGGTTTC -> TGACCTAGGTGTGGTTTCT
CTGACGACAAGGAGCCTCA -> TGACGACAAGGAGCCTCAG
CTGAGGCTCCGGATCCCAC -> TGAGGCTCCGGATCCCACA
CTGATACCCAAAAATGGTT -> TGATACCCAAAAATGGTTC
CTGATCGATCGTCTACAAG -> TGATCGATCGTCTACAAGA
CTGATTAATTATTAAACTA -> TGATTAATTATTAAACTAT
CTGATTTCCCCAGGATAGC -> TGATTTCCCCAGGATAGCG
CTGCACCCCCAAAGCAAAA -> TGCACCCCCAAAGCAAAAT
CTGCACTTAGAGCTGCTAA -> TGCACTTAGAGCTGCTAAT
CTGCAGCCAACACTGTATC -> TGCAGCCAACACTGTATCT
CTGCATTCTTTAGTTGTGC -> TGCATTCTTTAGTTGTGCG
CTGCCTCCCGTATCTCGCG -> TGCCTCCCGTATCTCGCGT
CTGCCTGACGACAAGGAGC -> TGCCTGACGACAAGGAGCC
CTGCCTGATTAATTATTAA -> TGCCTGATTAATTATTAAA
CTGCTAATGTAAGCTCTCA -> TGCTAATGTAAGCTCTCAC
CTGCTTCAAAGCGGGAGCC -> TGCTTCAAAGCGGGAGCCT
CTGCTTGGTCTAAGTTGTA -> TGCTTGGTCTAAGTTGTAC
CTGGACCTTATTATGCTTG -> TGGACCTTATTATGCTTGC
CTGGGAGCGCACGTAAAGA -> TGGGAGCGCACGTAAAGAT
CTGGGCGAGGACATATTAA -> TGGGCGAGGACATATTAAG
CTGGGGATAGCATTAATCG -> TGGGGATAGCATTAATCGA
CTGGGTGGTATGGCCTTGC -> TGGGTGGTATGGCCTTGCG
CTGGGTTTGTAAGCCACCG -> TGGGTTTGTAAGCCACCGG
CTGGTAAGAGTGGGGAAAT -> TGGTAAGAGTGGGGAAATG
CTGGTACATTGCCCTTCGT -> TGGTACATTGCCCTTCGTC
CTGGTCTCTCGAGTGCCGC -> TGGTCTCTCGAGTGCCGCG
CTGTACAATCTTCGTTCTA -> TGTACAATCTTCGTTCTAG
CTGTACGTTTTTGCTGTCT -> TGTACGTTTTTGCTGTCTG
CTGTATCTCTAGCTGCCTG -> TGTATCTCTAGCTGCCTGA
CTGTATTCTTGTACTACCG -> TGTATTCTTGTACTACCGC
CTGTCGCGTTCATCAAGTC -> TGTCGCGTTCATCAAGTCA
CTGTCGGTATAGGTTGTAC -> TGTCGGTATAGGTTGTACT
CTGTCTGGGAGCGCACGTA -> TGTCTGGGAGCGCACGTAA
CTGTGGCCTGTGGCGGGCA -> TGTGGCCTGTGGCGGGCAG
CTGTGGCGGGCAGAAAGTC -> TGTGGCGGGCAGAAAGTCA
CTGTGGTTAGGCCATAAAG -> TGTGGTTAGGCCATAAAGC
CTGTGGTTCTCCAAGTCGA -> TGTGGTTCTCCAAGTCGAT
CTGTTCAATGCTGCAGCCA -> TGTTCAATGCTGCAGCCAA
CTGTTCGCGGATGTGTGCG -> TGTTCGCGGATGTGTGCGC
CTGTTGGATCAGTTACGTC -> TGTTGGATCAGTTACGTCA
CTTAAGATATAGTATCATC -> TTAAGATATAGTATCATCC
CTTAGAGCTGCTAATGTAA -> TTAGAGCTGCTAATGTAAG
CTTATCTTTGGCTGGTACA -> TTATCTTTGGCTGGTACAT
CTTATTATGCTTGCTTATC -> TTATTATGCTTGCTTATCT
CTTCAAAGCGGGAGCCTGG -> TTCAAAGCGGGAGCCTGGT
CTTCATCTGGACCTTATTA -> TTCATCTGGACCTTATTAT
CTTCCATGAGATGGCCGCT -> TTCCATGAGATGGCCGCTG
CTTCGCATAGTAGGGCCAC -> TTCGCATAGTAGGGCCACC
CTTCGGAGGAGGCAGACTC -> TTCGGAGGAGGCAGACTCG
CTTCGTCCGCTCTGTTCAA -> TTCGTCCGCTCTGTTCAAT
CTTCGTTCTAGTCTGGGGA -> TTCGTTCTAGTCTGGGGAT
CTTCTTGAATTGTATCCGT -> TTCTTGAATTGTATCCGTG
CTTCTTTGCCTGGTAAGAG -> TTCTTTGCCTGGTAAGAGT
CTTGAATTGTATCCGTGTA -> TTGAATTGTATCCGTGTAG
CTTGAGTTGAAACCGCCCG -> TTGAGTTGAAACCGCCCGA
CTTGCCCGCGTTCAGATCG -> TTGCCCGCGTTCAGATCGT
CTTGCGAACAGAGAATTCG -> TTGCGAACAGAGAATTCGA
CTTGCTTATCTTTGGCTGG -> TTGCTTATCTTTGGCTGGT
CTTGGTCTAAGTTGTACCG -> TTGGTCTAAGTTGTACCGG
CTTGTACTACCGCCGGACA -> TTGTACTACCGCCGGACAC
CTTGTACTACCGCGTACCA -> TTGTACTACCGCGTACCAT
CTTGTACTACCGCGTCAGT -> TTGTACTACCGCGTCAGTT
CTTGTACTACCGCTTAAGA -> TTGTACTACCGCTTAAGAT
CTTTAACGGCTACACGGTC -> TTTAACGGCTACACGGTCA
CTTTAGTTGTGCGAACTGC -> TTTAGTTGTGCGAACTGCA
CTTTGCCTGGTAAGAGTGG -> TTTGCCTGGTAAGAGTGGG
CTTTGGACCAACACAATTC -> TTTGGACCAACACAATTCG
CTTTGGCTGGTACATTGCC -> TTTGGCTGGTACATTGCCC
CTTTTGTAACTGTACAATC -> TTTTGTAACTGTACAATCT
CTTTTTACGGGTGAGCCAG -> TTTTTACGGGTGAGCCAGC
GAAAAAGAGAAACTAGCGA -> AAAAAGAGAAACTAGCGAC
GAAAAGGCTAGCACGCCTA -> AAAAGGCTAGCACGCCTAT
GAAAATGGAGACTCAAACC -> AAAATGGAGACTCAAACCA
GAAACCGCCCGAGGGGTTC -> AAACCGCCCGAGGGGTTCA
GAAACTAGCGACATCACAA -> AAACTAGCGACATCACAAT
GAAAGTCAAAAAGACACTT -> AAAGTCAAAAAGACACTTG
GAAATGTTGCCAGAGAGAG -> AAATGTTGCCAGAGAGAGT
GAACAATTTAATCCGGCTC -> AACAATTTAATCCGGCTCA
GAACAGAGAATTCGATTGC -> AACAGAGAATTCGATTGCA
GAACCGTATATGGCGTCTA -> AACCGTATATGGCGTCTAA
GAACGATAAGCCTCCTACA -> AACGATAAGCCTCCTACAA
GAACTAGCGGCCTCCGCCC -> AACTAGCGGCCTCCGCCCT
GAACTGCACCCCCAAAGCA -> AACTGCACCCCCAAAGCAA
GAAGGGTATGCGTGTTCTG -> AAGGGTATGCGTGTTCTGT
GAAGGGTCGCTGCACTTAG -> AAGGGTCGCTGCACTTAGA
GAAGTACCTGCATTCTTTA -> AAGTACCTGCATTCTTTAG
GAAGTCCCGGACTCATTGG -> AAGTCCCGGACTCATTGGA
GAAGTCGACGACGTCTAAG -> AAGTCGACGACGTCTAAGC
GAATGTGAAAATGGAGACT -> AATGTGAAAATGGAGACTC
GAATTCGATTGCAACGTAC -> AATTCGATTGCAACGTACT
GAATTCGCCAAATTAAACG -> AATTCGCCAAATTAAACGA
GAATTGTATCCGTGTAGTC -> AATTGTATCCGTGTAGTCG
GACAAACCGGTAGCCCAAC -> ACAAACCGGTAGCCCAACA
GACAAGACACGATCGCCGG -> ACAAGACACGATCGCCGGA
GACAAGCCATACACGGTTA -> ACAAGCCATACACGGTTAG
GACAAGCGTCTCAACATCA -> ACAAGCGTCTCAACATCAG
GACAAGGAGCCTCAGCAGC -> ACAAGGAGCCTCAGCAGCC
GACACAACCATACTGATCG -> ACACAACCATACTGATCGA
GACACGATCGCCGGAGAAT -> ACACGATCGCCGGAGAATG
GACACTTGCCCGCGTTCAG -> ACACTTGCCCGCGTTCAGA
GACAGCACATGTACTAACT -> ACAGCACATGTACTAACTA
GACATAACTAAAGTGTACT -> ACATAACTAAAGTGTACTA
GACATATTAAGGTAAGCGA -> ACATATTAAGGTAAGCGAG
GACATCACAATGCAAGTCG -> ACATCACAATGCAAGTCGA
GACCAACACAATTCGTGGT -> ACCAACACAATTCGTGGTA
GACCGTTATCAGAGGATAC -> ACCGTTATCAGAGGATACC
GACCTAGGTGTGGTTTCTG -> ACCTAGGTGTGGTTTCTGC
GACCTTATTATGCTTGCTT -> ACCTTATTATGCTTGCTTA
GACCTTTGGACCAACACAA -> ACCTTTGGACCAACACAAT
GACGACAAGGAGCCTCAGC -> ACGACAAGGAGCCTCAGCA
GACGACGTCTAAGCAGTCC -> ACGACGTCTAAGCAGTCCA
GACGCAAGTCGTGCCAGAC -> ACGCAAGTCGTGCCAGACA
GACGCGCACAGCAATCTGG -> ACGCGCACAGCAATCTGGG
GACGTCTAAGCAGTCCAAA -> ACGTCTAAGCAGTCCAAAG
GACGTGCTCGGATGGACTG -> ACGTGCTCGGATGGACTGG
GACTCAAACCATAGTATCG -> ACTCAAACCATAGTATCGC
GACTCATTGGAGAGACAAG -> ACTCATTGGAGAGACAAGC
GACTCGCGGAGTCGCTCAT -> ACTCGCGGAGTCGCTCATA
GAGAAACTAGCGACATCAC -> AGAAACTAGCGACATCACA
GAGAATGTGAAAATGGAGA -> AGAATGTGAAAATGGAGAC
GAGAATTCGATTGCAACGT -> AGAATTCGATTGCAACGTA
GAGACAAGCCATACACGGT -> AGACAAGCCATACACGGTT
GAGACATAACTAAAGTGTA -> AGACATAACTAAAGTGTAC
GAGACTCAAACCATAGTAT -> AGACTCAAACCATAGTATC
GAGAGACAAGCCATACACG -> AGAGACAAGCCATACACGG
GAGAGAGTGCAACTAACGG -> AGAGAGTGCAACTAACGGC
GAGAGTGCAACTAACGGCC -> AGAGTGCAACTAACGGCCC
GAGATGGCCGCTGACCTAG -> AGATGGCCGCTGACCTAGG
GAGCAAGTCAAGCCCATGT -> AGCAAGTCAAGCCCATGTA
GAGCAATCGTATCTGATTT -> AGCAATCGTATCTGATTTC
GAGCACCCTATATTCATGT -> AGCACCCTATATTCATGTA
GAGCAGCTCCCGGCCCTGT -> AGCAGCTCCCGGCCCTGTA
GAGCATGGTTCCCCAGTGT -> AGCATGGTTCCCCAGTGTA
GAGCCAGCGGGCCGGGCTG -> AGCCAGCGGGCCGGGCTGG
GAGCCTCAGCAGCCGAGGC -> AGCCTCAGCAGCCGAGGCA
GAGCCTGGTCTCTCGAGTG -> AGCCTGGTCTCTCGAGTGC
GAGCGCACGTAAAGATTTG -> AGCGCACGTAAAGATTTGC
GAGCTAAAGCCGCAACGAG -> AGCTAAAGCCGCAACGAGG
GAGCTACAAGAGTTAAGAG -> AGCTACAAGAGTTAAGAGC
GAGCTAGCGGGCTAGTTCT -> AGCTAGCGGGCTAGTTCTG
GAGCTGCTAATGTAAGCTC -> AGCTGCTAATGTAAGCTCT
GAGGAAGTACCTGCATTCT -> AGGAAGTACCTGCATTCTT
GAGGACATATTAAGGTAAG -> AGGACATATTAAGGTAAGC
GAGGAGGCAGACTCGCGGA -> AGGAGGCAGACTCGCGGAG
GAGGATACCCGTGCACACT -> AGGATACCCGTGCACACTA
GAGGCAGACTCGCGGAGTC -> AGGCAGACTCGCGGAGTCG
GAGGCATCCTGTGGCCTGT -> AGGCATCCTGTGGCCTGTG
GAGGCTACATCTACCGATC -> AGGCTACATCTACCGATCG
GAGGCTCCGGATCCCACAG -> AGGCTCCGGATCCCACAGC
GAGGGAGCAATCGTATCTG -> AGGGAGCAATCGTATCTGA
GAGGGGTTCATCTAATCTG -> AGGGGTTCATCTAATCTGT
GAGTAGATACTGTCGGTAT -> AGTAGATACTGTCGGTATA
GAGTATAAATGGCTGTACG -> AGTATAAATGGCTGTACGT
GAGTCCGTGAGGCTACATC -> AGTCCGTGAGGCTACATCT
GAGTCGCTCATAACTGATA -> AGTCGCTCATAACTGATAC
GAGTCGGCAATCAAGCCGG -> AGTCGGCAATCAAGCCGGC
GAGTGCAACTAACGGCCCA -> AGTGCAACTAACGGCCCAA
GAGTGCCGCGTTATACGCA -> AGTGCCGCGTTATACGCAA
GAGTGGGGAAATGTTGCCA -> AGTGGGGAAATGTTGCCAG
GAGTTAAGAGCAAGTCAAG -> AGTTAAGAGCAAGTCAAGC
GAGTTAAGAGCACCCTATA -> AGTTAAGAGCACCCTATAT
GAGTTAAGAGCAGCTCCCG -> AGTTAAGAGCAGCTCCCGG
GAGTTAAGAGCATGGTTCC -> AGTTAAGAGCATGGTTCCC
GAGTTGAAACCGCCCGAGG -> AGTTGAAACCGCCCGAGGG
GAGTTTCGACGTGCTCGGA -> AGTTTCGACGTGCTCGGAT
GATAAGCCTCCTACAACAC -> ATAAGCCTCCTACAACACT
GATACCCAAAAATGGTTCG -> ATACCCAAAAATGGTTCGA
GATACCCGTGCACACTACT -> ATACCCGTGCACACTACTG
GATACTGTCGGTATAGGTT -> ATACTGTCGGTATAGGTTG
GATAGCATTAATCGAGCTA -> ATAGCATTAATCGAGCTAG
GATAGCGGGTCGAGTATAA -> ATAGCGGGTCGAGTATAAA
GATATAGTATCATCCCTTT -> ATATAGTATCATCCCTTTA
GATCAGTTACGTCAGTAGG -> ATCAGTTACGTCAGTAGGT
GATCATCTTCATCTGGACC -> ATCATCTTCATCTGGACCT
GATCCCACAGCCTGTTGGA -> ATCCCACAGCCTGTTGGAT
GATCCTACCAGGAGTTTCG -> ATCCTACCAGGAGTTTCGA
GATCGATCGTCTACAAGAG -> ATCGATCGTCTACAAGAGT
GATCGCCGGAGAATGTGAA -> ATCGCCGGAGAATGTGAAA
GATCGCCTGCCTCCCGTAT -> ATCGCCTGCCTCCCGTATC
GATCGGTTTGGGGCGAAGG -> ATCGGTTTGGGGCGAAGGG
GATCGTAGACGCGCACAGC -> ATCGTAGACGCGCACAGCA
GATCGTCGAGCTAAAGCCG -> ATCGTCGAGCTAAAGCCGC
GATCGTCTACAAGAGTTAA -> ATCGTCTACAAGAGTTAAG
GATCGTCTATCCTACAAGA -> ATCGTCTATCCTACAAGAG
GATCTGCCTGATTAATTAT -> ATCTGCCTGATTAATTATT
GATGATCGTCGAGCTAAAG -> ATGATCGTCGAGCTAAAGC
GATGGCCGCTGACCTAGGT -> ATGGCCGCTGACCTAGGTG
GATGTGATCGTAGACGCGC -> ATGTGATCGTAGACGCGCA
GATGTGCCCAACAAGAAGT -> ATGTGCCCAACAAGAAGTC
GATGTGTGCGCATAGGGTA -> ATGTGTGCGCATAGGGTAC
GATTAATTATTAAACTATG -> ATTAATTATTAAACTATGC
GATTGCAACGTACTCACGA -> ATTGCAACGTACTCACGAT
GATTTAAAAGTGTACAGAA -> ATTTAAAAGTGTACAGAAT
GATTTCCCCAGGATAGCGG -> ATTTCCCCAGGATAGCGGG
GATTTGCAACTTTTGTAAC -> ATTTGCAACTTTTGTAACT
GATTTGCAGGGAAAAAGAG -> ATTTGCAGGGAAAAAGAGA
GCAAAATTTCAGGTTGCCT -> CAAAATTTCAGGTTGCCTT
GCAACGAGGAAGTACCTGC -> CAACGAGGAAGTACCTGCA
GCAACGTACTCACGATGTG -> CAACGTACTCACGATGTGC
GCAACTAACGGCCCAACCC -> CAACTAACGGCCCAACCCA
GCAACTTTTGTAACTGTAC -> CAACTTTTGTAACTGTACA
GCAAGTCAAGCCCATGTAT -> CAAGTCAAGCCCATGTATT
GCAAGTCGATCTGCCTGAT -> CAAGTCGATCTGCCTGATT
GCAAGTCGTGCCAGACAAA -> CAAGTCGTGCCAGACAAAC
GCAATAGCAGTTAGATCGG -> CAATAGCAGTTAGATCGGT
GCAATCAAGCCGGCACAGA -> CAATCAAGCCGGCACAGAG
GCAATCGTATCTGATTTCC -> CAATCGTATCTGATTTCCC
GCAATCTGGGCGAGGACAT -> CAATCTGGGCGAGGACATA
GCACACTACTGAACAATTT -> CACACTACTGAACAATTTA
GCACAGAGTCCGTGAGGCT -> CACAGAGTCCGTGAGGCTA
GCACAGCAATCTGGGCGAG -> CACAGCAATCTGGGCGAGG
GCACATGTACTAACTACAA -> CACATGTACTAACTACAAG
GCACCCCCAAAGCAAAATT -> CACCCCCAAAGCAAAATTT
GCACCCTATATTCATGTAT -> CACCCTATATTCATGTATT
GCACGAGACATAACTAAAG -> CACGAGACATAACTAAAGT
GCACGCCTATTAAAGAAGT -> CACGCCTATTAAAGAAGTC
GCACGGATTTAAAAGTGTA -> CACGGATTTAAAAGTGTAC
GCACGTAAAGATTTGCAGG -> CACGTAAAGATTTGCAGGG
GCACTTAGAGCTGCTAATG -> CACTTAGAGCTGCTAATGT
GCAGAAAGTCAAAAAGACA -> CAGAAAGTCAAAAAGACAC
GCAGACTCGCGGAGTCGCT -> CAGACTCGCGGAGTCGCTC
GCAGCCAACACTGTATCTC -> CAGCCAACACTGTATCTCT
GCAGCCGAGGCATCCTGTG -> CAGCCGAGGCATCCTGTGG
GCAGCTCCCGGCCCTGTAT -> CAGCTCCCGGCCCTGTATT
GCAGGGAAAAAGAGAAACT -> CAGGGAAAAAGAGAAACTA
GCAGTCCAAAGGGAGCTAC -> CAGTCCAAAGGGAGCTACA
GCAGTTAGATCGGTTTGGG -> CAGTTAGATCGGTTTGGGG
GCATAGGGTACCTTCTTTG -> CATAGGGTACCTTCTTTGC
GCATAGTAGGGCCACCCCA -> CATAGTAGGGCCACCCCAT
GCATCCTGTGGCCTGTGGC -> CATCCTGTGGCCTGTGGCG
GCATGGTTCCCCAGTGTAT -> CATGGTTCCCCAGTGTATT
GCATTAATCGAGCTAGCGG -> CATTAATCGAGCTAGCGGG
GCATTCTTTAGTTGTGCGA -> CATTCTTTAGTTGTGCGAA
GCCAAATTAAACGATCATC -> CCAAATTAAACGATCATCT
GCCAACACTGTATCTCTAG -> CCAACACTGTATCTCTAGC
GCCACCCCATCAATTCACA -> CCACCCCATCAATTCACAT
GCCACCGGTACACGTGCCC -> CCACCGGTACACGTGCCCG
GCCACGAAAAGGCTAGCAC -> CCACGAAAAGGCTAGCACG
GCCAGACAAACCGGTAGCC -> CCAGACAAACCGGTAGCCC
GCCAGAGAGAGTGCAACTA -> CCAGAGAGAGTGCAACTAA
GCCAGCGGGCCGGGCTGGG -> CCAGCGGGCCGGGCTGGGT
GCCAGGCGGCGAACGATAA -> CCAGGCGGCGAACGATAAG
GCCATAAAGCACGAGACAT -> CCATAAAGCACGAGACATA
GCCATACACGGTTAGATGT -> CCATACACGGTTAGATGTG
GCCCAACAAGAAGTCGACG -> CCCAACAAGAAGTCGACGA
GCCCAACATGCTGTGGTTA -> CCCAACATGCTGTGGTTAG
GCCCAACCCAACTGTCGCG -> CCCAACCCAACTGTCGCGT
GCCCATGTATTCTTGTACT -> CCCATGTATTCTTGTACTA
GCCCGAGGGGTTCATCTAA -> CCCGAGGGGTTCATCTAAT
GCCCGCGTTCAGATCGTCT -> CCCGCGTTCAGATCGTCTA
GCCCGTCGCTTCTTGAATT -> CCCGTCGCTTCTTGAATTG
GCCCTGCTTGGTCTAAGTT -> CCCTGCTTGGTCTAAGTTG
GCCCTGTATTCTTGTACTA -> CCCTGTATTCTTGTACTAC
GCCCTTCGTCCGCTCTGTT -> CCCTTCGTCCGCTCTGTTC
GCCGAGGCATCCTGTGGCC -> CCGAGGCATCCTGTGGCCT
GCCGCAACGAGGAAGTACC -> CCGCAACGAGGAAGTACCT
GCCGCGTTATACGCAATAG -> CCGCGTTATACGCAATAGC
GCCGCTGACCTAGGTGTGG -> CCGCTGACCTAGGTGTGGT
GCCGGACACAACCATACTG -> CCGGACACAACCATACTGA
GCCGGAGAATGTGAAAATG -> CCGGAGAATGTGAAAATGG
GCCGGCACAGAGTCCGTGA -> CCGGCACAGAGTCCGTGAG
GCCGGGCTGGGTGGTATGG -> CCGGGCTGGGTGGTATGGC
GCCGGTTGGCCAGGCGGCG -> CCGGTTGGCCAGGCGGCGA
GCCTATTAAAGAAGTCCCG -> CCTATTAAAGAAGTCCCGG
GCCTCAGCAGCCGAGGCAT -> CCTCAGCAGCCGAGGCATC
GCCTCCCGTATCTCGCGTT -> CCTCCCGTATCTCGCGTTG
GCCTCCGCCCTGCTTGGTC -> CCTCCGCCCTGCTTGGTCT
GCCTCCTACAACACTTCGC -> CCTCCTACAACACTTCGCA
GCCTGACGACAAGGAGCCT -> CCTGACGACAAGGAGCCTC
GCCTGATTAATTATTAAAC -> CCTGATTAATTATTAAACT
GCCTGCCTCCCGTATCTCG -> CCTGCCTCCCGTATCTCGC
GCCTGGTAAGAGTGGGGAA -> CCTGGTAAGAGTGGGGAAA
GCCTGGTCTCTCGAGTGCC -> CCTGGTCTCTCGAGTGCCG
GCCTGTGGCGGGCAGAAAG -> CCTGTGGCGGGCAGAAAGT
GCCTGTTGGATCAGTTACG -> CCTGTTGGATCAGTTACGT
GCCTTGAGTTGAAACCGCC -> CCTTGAGTTGAAACCGCCC
GCCTTGCGAACAGAGAATT -> CCTTGCGAACAGAGAATTC
GCGAACAGAGAATTCGATT -> CGAACAGAGAATTCGATTG
GCGAACGATAAGCCTCCTA -> CGAACGATAAGCCTCCTAC
GCGAACTAGCGGCCTCCGC -> CGAACTAGCGGCCTCCGCC
GCGAACTGCACCCCCAAAG -> CGAACTGCACCCCCAAAGC
GCGAAGGGTATGCGTGTTC -> CGAAGGGTATGCGTGTTCT
GCGAAGGGTCGCTGCACTT -> CGAAGGGTCGCTGCACTTA
GCGACATCACAATGCAAGT -> CGACATCACAATGCAAGTC
GCGAGGACATATTAAGGTA -> CGAGGACATATTAAGGTAA
GCGAGGGAGCAATCGTATC -> CGAGGGAGCAATCGTATCT
GCGATCCTACCAGGAGTTT -> CGATCCTACCAGGAGTTTC
GCGATGATCGTCGAGCTAA -> CGATGATCGTCGAGCTAAA
GCGCACAGCAATCTGGGCG -> CGCACAGCAATCTGGGCGA
GCGCACGTAAAGATTTGCA -> CGCACGTAAAGATTTGCAG
GCGCATAGGGTACCTTCTT -> CGCATAGGGTACCTTCTTT
GCGCGATCCTACCAGGAGT -> CGCGATCCTACCAGGAGTT
GCGGAGTCGCTCATAACTG -> CGGAGTCGCTCATAACTGA
GCGGATGTGTGCGCATAGG -> CGGATGTGTGCGCATAGGG
GCGGCCTCCGCCCTGCTTG -> CGGCCTCCGCCCTGCTTGG
GCGGCGAACGATAAGCCTC -> CGGCGAACGATAAGCCTCC
GCGGGAGCCTGGTCTCTCG -> CGGGAGCCTGGTCTCTCGA
GCGGGCAGAAAGTCAAAAA -> CGGGCAGAAAGTCAAAAAG
GCGGGCCGGGCTGGGTGGT -> CGGGCCGGGCTGGGTGGTA
GCGGGCTAGTTCTGGGTTT -> CGGGCTAGTTCTGGGTTTG
GCGGGTCGAGTATAAATGG -> CGGGTCGAGTATAAATGGC
GCGTAACCGGACCTTTGGA -> CGTAACCGGACCTTTGGAC
GCGTACCATATGGTATTTT -> CGTACCATATGGTATTTTG
GCGTCAGTTCACGACAAGC -> CGTCAGTTCACGACAAGCG
GCGTCTAAGGCCACGAAAA -> CGTCTAAGGCCACGAAAAG
GCGTCTCAACATCAGCCGG -> CGTCTCAACATCAGCCGGT
GCGTGTTCTGTGGTTCTCC -> CGTGTTCTGTGGTTCTCCA
GCGTTATACGCAATAGCAG -> CGTTATACGCAATAGCAGT
GCGTTCAGATCGTCTATCC -> CGTTCAGATCGTCTATCCT
GCGTTCATCAAGTCAAACC -> CGTTCATCAAGTCAAACCA
GCGTTGCTTTTTACGGGTG -> CGTTGCTTTTTACGGGTGA
GCTAAAGCCGCAACGAGGA -> CTAAAGCCGCAACGAGGAA
GCTAATGTAAGCTCTCACT -> CTAATGTAAGCTCTCACTC
GCTACAAGAGTTAAGAGCA -> CTACAAGAGTTAAGAGCAG
GCTACACGGTCACGACAGC -> CTACACGGTCACGACAGCA
GCTACATCTACCGATCGCC -> CTACATCTACCGATCGCCT
GCTAGCACGCCTATTAAAG -> CTAGCACGCCTATTAAAGA
GCTAGCGGGCTAGTTCTGG -> CTAGCGGGCTAGTTCTGGG
GCTAGTTCTGGGTTTGTAA -> CTAGTTCTGGGTTTGTAAG
GCTCACGTTACAGAGTCGG -> CTCACGTTACAGAGTCGGC
GCTCATAACTGATACCCAA -> CTCATAACTGATACCCAAA
GCTCCCGGCCCTGTATTCT -> CTCCCGGCCCTGTATTCTT
GCTCCGGATCCCACAGCCT -> CTCCGGATCCCACAGCCTG
GCTCGGATGGACTGGTGCG -> CTCGGATGGACTGGTGCGA
GCTCTCACTCTTCGGAGGA -> CTCTCACTCTTCGGAGGAG
GCTCTGTTCAATGCTGCAG -> CTCTGTTCAATGCTGCAGC
GCTGACCTAGGTGTGGTTT -> CTGACCTAGGTGTGGTTTC
GCTGAGGCTCCGGATCCCA -> CTGAGGCTCCGGATCCCAC
GCTGCACTTAGAGCTGCTA -> CTGCACTTAGAGCTGCTAA
GCTGCAGCCAACACTGTAT -> CTGCAGCCAACACTGTATC
GCTGCCTGACGACAAGGAG -> CTGCCTGACGACAAGGAGC
GCTGCTAATGTAAGCTCTC -> CTGCTAATGTAAGCTCTCA
GCTGGGTGGTATGGCCTTG -> CTGGGTGGTATGGCCTTGC
GCTGGTACATTGCCCTTCG -> CTGGTACATTGCCCTTCGT
GCTGTACGTTTTTGCTGTC -> CTGTACGTTTTTGCTGTCT
GCTGTCTGGGAGCGCACGT -> CTGTCTGGGAGCGCACGTA
GCTGTGGTTAGGCCATAAA -> CTGTGGTTAGGCCATAAAG
GCTTAAGATATAGTATCAT -> CTTAAGATATAGTATCATC
GCTTATCTTTGGCTGGTAC -> CTTATCTTTGGCTGGTACA
GCTTCAAAGCGGGAGCCTG -> CTTCAAAGCGGGAGCCTGG
GCTTCTTGAATTGTATCCG -> CTTCTTGAATTGTATCCGT
GCTTGCTTATCTTTGGCTG -> CTTGCTTATCTTTGGCTGG
GCTTGGTCTAAGTTGTACC -> CTTGGTCTAAGTTGTACCG
GCTTTTTACGGGTGAGCCA -> CTTTTTACGGGTGAGCCAG
GGAAAAAGAGAAACTAGCG -> GAAAAAGAGAAACTAGCGA
GGAAATGTTGCCAGAGAGA -> GAAATGTTGCCAGAGAGAG
GGAAGTACCTGCATTCTTT -> GAAGTACCTGCATTCTTTA
GGACACAACCATACTGATC -> GACACAACCATACTGATCG
GGACATATTAAGGTAAGCG -> GACATATTAAGGTAAGCGA
GGACCAACACAATTCGTGG -> GACCAACACAATTCGTGGT
GGACCGTTATCAGAGGATA -> GACCGTTATCAGAGGATAC
GGACCTTATTATGCTTGCT -> GACCTTATTATGCTTGCTT
GGACCTTTGGACCAACACA -> GACCTTTGGACCAACACAA
GGACTCATTGGAGAGACAA -> GACTCATTGGAGAGACAAG
GGAGAATGTGAAAATGGAG -> GAGAATGTGAAAATGGAGA
GGAGACTCAAACCATAGTA -> GAGACTCAAACCATAGTAT
GGAGAGACAAGCCATACAC -> GAGAGACAAGCCATACACG
GGAGCAATCGTATCTGATT -> GAGCAATCGTATCTGATTT
GGAGCCTCAGCAGCCGAGG -> GAGCCTCAGCAGCCGAGGC
GGAGCCTGGTCTCTCGAGT -> GAGCCTGGTCTCTCGAGTG
GGAGCGCACGTAAAGATTT -> GAGCGCACGTAAAGATTTG
GGAGCTACAAGAGTTAAGA -> GAGCTACAAGAGTTAAGAG
GGAGGAGGCAGACTCGCGG -> GAGGAGGCAGACTCGCGGA
GGAGGCAGACTCGCGGAGT -> GAGGCAGACTCGCGGAGTC
GGAGTAGATACTGTCGGTA -> GAGTAGATACTGTCGGTAT
GGAGTCGCTCATAACTGAT -> GAGTCGCTCATAACTGATA
GGAGTTTCGACGTGCTCGG -> GAGTTTCGACGTGCTCGGA
GGATACCCGTGCACACTAC -> GATACCCGTGCACACTACT
GGATAGCATTAATCGAGCT -> GATAGCATTAATCGAGCTA
GGATAGCGGGTCGAGTATA -> GATAGCGGGTCGAGTATAA
GGATCAGTTACGTCAGTAG -> GATCAGTTACGTCAGTAGG
GGATCCCACAGCCTGTTGG -> GATCCCACAGCCTGTTGGA
GGATGGACTGGTGCGATTG -> GATGGACTGGTGCGATTGC
GGATGTGTGCGCATAGGGT -> GATGTGTGCGCATAGGGTA
GGATTTAAAAGTGTACAGA -> GATTTAAAAGTGTACAGAA
GGCAATCAAGCCGGCACAG -> GCAATCAAGCCGGCACAGA
GGCACAGAGTCCGTGAGGC -> GCACAGAGTCCGTGAGGCT
GGCAGAAAGTCAAAAAGAC -> GCAGAAAGTCAAAAAGACA
GGCAGACTCGCGGAGTCGC -> GCAGACTCGCGGAGTCGCT
GGCATCCTGTGGCCTGTGG -> GCATCCTGTGGCCTGTGGC
GGCCACCCCATCAATTCAC -> GCCACCCCATCAATTCACA
GGCCACGAAAAGGCTAGCA -> GCCACGAAAAGGCTAGCAC
GGCCAGGCGGCGAACGATA -> GCCAGGCGGCGAACGATAA
GGCCATAAAGCACGAGACA -> GCCATAAAGCACGAGACAT
GGCCCAACCCAACTGTCGC -> GCCCAACCCAACTGTCGCG
GGCCCTGTATTCTTGTACT -> GCCCTGTATTCTTGTACTA
GGCCGCTGACCTAGGTGTG -> GCCGCTGACCTAGGTGTGG
GGCCGGGCTGGGTGGTATG -> GCCGGGCTGGGTGGTATGG
GGCCTCCGCCCTGCTTGGT -> GCCTCCGCCCTGCTTGGTC
GGCCTGTGGCGGGCAGAAA -> GCCTGTGGCGGGCAGAAAG
GGCCTTGCGAACAGAGAAT -> GCCTTGCGAACAGAGAATT
GGCGAACGATAAGCCTCCT -> GCGAACGATAAGCCTCCTA
GGCGAAGGGTCGCTGCACT -> GCGAAGGGTCGCTGCACTT
GGCGAGGACATATTAAGGT -> GCGAGGACATATTAAGGTA
GGCGGCGAACGATAAGCCT -> GCGGCGAACGATAAGCCTC
GGCGGGCAGAAAGTCAAAA -> GCGGGCAGAAAGTCAAAAA
GGCGTCTAAGGCCACGAAA -> GCGTCTAAGGCCACGAAAA
GGCTACACGGTCACGACAG -> GCTACACGGTCACGACAGC
GGCTACATCTACCGATCGC -> GCTACATCTACCGATCGCC
GGCTAGCACGCCTATTAAA -> GCTAGCACGCCTATTAAAG
GGCTAGTTCTGGGTTTGTA -> GCTAGTTCTGGGTTTGTAA
GGCTCACGTTACAGAGTCG -> GCTCACGTTACAGAGTCGG
GGCTCCGGATCCCACAGCC -> GCTCCGGATCCCACAGCCT
GGCTGGGTGGTATGGCCTT -> GCTGGGTGGTATGGCCTTG
GGCTGGTACATTGCCCTTC -> GCTGGTACATTGCCCTTCG
GGCTGTACGTTTTTGCTGT -> GCTGTACGTTTTTGCTGTC
GGGAAAAAGAGAAACTAGC -> GGAAAAAGAGAAACTAGCG
GGGAAATGTTGCCAGAGAG -> GGAAATGTTGCCAGAGAGA
GGGAGCAATCGTATCTGAT -> GGAGCAATCGTATCTGATT
GGGAGCCTGGTCTCTCGAG -> GGAGCCTGGTCTCTCGAGT
GGGAGCGCACGTAAAGATT -> GGAGCGCACGTAAAGATTT
GGGAGCTACAAGAGTTAAG -> GGAGCTACAAGAGTTAAGA
GGGATAGCATTAATCGAGC -> GGATAGCATTAATCGAGCT
GGGCAGAAAGTCAAAAAGA -> GGCAGAAAGTCAAAAAGAC
GGGCCACCCCATCAATTCA -> GGCCACCCCATCAATTCAC
GGGCCGGGCTGGGTGGTAT -> GGCCGGGCTGGGTGGTATG
GGGCGAAGGGTCGCTGCAC -> GGCGAAGGGTCGCTGCACT
GGGCGAGGACATATTAAGG -> GGCGAGGACATATTAAGGT
GGGCTAGTTCTGGGTTTGT -> GGCTAGTTCTGGGTTTGTA
GGGCTGGGTGGTATGGCCT -> GGCTGGGTGGTATGGCCTT
GGGGAAATGTTGCCAGAGA -> GGGAAATGTTGCCAGAGAG
GGGGATAGCATTAATCGAG -> GGGATAGCATTAATCGAGC
GGGGCGAAGGGTCGCTGCA -> GGGCGAAGGGTCGCTGCAC
GGGGTTCATCTAATCTGTT -> GGGTTCATCTAATCTGTTC
GGGTACCTTCTTTGCCTGG -> GGTACCTTCTTTGCCTGGT
GGGTATGCGTGTTCTGTGG -> GGTATGCGTGTTCTGTGGT
GGGTCGAGTATAAATGGCT -> GGTCGAGTATAAATGGCTG
GGGTCGCTGCACTTAGAGC -> GGTCGCTGCACTTAGAGCT
GGGTGAGCCAGCGGGCCGG -> GGTGAGCCAGCGGGCCGGG
GGGTGGTATGGCCTTGCGA -> GGTGGTATGGCCTTGCGAA
GGGTTCATCTAATCTGTTC -> GGTTCATCTAATCTGTTCG
GGGTTTGTAAGCCACCGGT -> GGTTTGTAAGCCACCGGTA
GGTAAGAGTGGGGAAATGT -> GTAAGAGTGGGGAAATGTT
GGTAAGCGAGGGAGCAATC -> GTAAGCGAGGGAGCAATCG
GGTACACGTGCCCGTCGCT -> GTACACGTGCCCGTCGCTT
GGTACATTGCCCTTCGTCC -> GTACATTGCCCTTCGTCCG
GGTACCTTCTTTGCCTGGT -> GTACCTTCTTTGCCTGGTA
GGTAGCCCAACATGCTGTG -> GTAGCCCAACATGCTGTGG
GGTAGTCCATCGTTCCCAG -> GTAGTCCATCGTTCCCAGC
GGTATACCACCCTCCCTTC -> GTATACCACCCTCCCTTCC
GGTATAGGTTGTACTAAGT -> GTATAGGTTGTACTAAGTA
GGTATGCGTGTTCTGTGGT -> GTATGCGTGTTCTGTGGTT
GGTATGGCCTTGCGAACAG -> GTATGGCCTTGCGAACAGA
GGTATTTTGCGAAGGGTAT -> GTATTTTGCGAAGGGTATG
GGTCACGACAGCACATGTA -> GTCACGACAGCACATGTAC
GGTCGAGTATAAATGGCTG -> GTCGAGTATAAATGGCTGT
GGTCGCTGCACTTAGAGCT -> GTCGCTGCACTTAGAGCTG
GGTCTAAGTTGTACCGGAG -> GTCTAAGTTGTACCGGAGT
GGTCTCTCGAGTGCCGCGT -> GTCTCTCGAGTGCCGCGTT
GGTGAGCCAGCGGGCCGGG -> GTGAGCCAGCGGGCCGGGC
GGTGGTATGGCCTTGCGAA -> GTGGTATGGCCTTGCGAAC
GGTGTGGTTTCTGCTTCAA -> GTGTGGTTTCTGCTTCAAA
GGTTAGATGTGATCGTAGA -> GTTAGATGTGATCGTAGAC
GGTTAGGCCATAAAGCACG -> GTTAGGCCATAAAGCACGA
GGTTCATCTAATCTGTTCG -> GTTCATCTAATCTGTTCGC
GGTTCCCCAGTGTATTCTT -> GTTCCCCAGTGTATTCTTG
GGTTCGACGCAAGTCGTGC -> GTTCGACGCAAGTCGTGCC
GGTTCTCCAAGTCGATTTG -> GTTCTCCAAGTCGATTTGC
GGTTGCCTTGAGTTGAAAC -> GTTGCCTTGAGTTGAAACC
GGTTGGCCAGGCGGCGAAC -> GTTGGCCAGGCGGCGAACG
GGTTGTACTAAGTATCAGA -> GTTGTACTAAGTATCAGAA
GGTTTCTGCTTCAAAGCGG -> GTTTCTGCTTCAAAGCGGG
GGTTTGGGGCGAAGGGTCG -> GTTTGGGGCGAAGGGTCGC
GGTTTGTAAGCCACCGGTA -> GTTTGTAAGCCACCGGTAC
GTAAAGATTTGCAGGGAAA -> TAAAGATTTGCAGGGAAAA
GTAACCGGACCTTTGGACC -> TAACCGGACCTTTGGACCA
GTAACTGTACAATCTTCGT -> TAACTGTACAATCTTCGTT
GTAAGAGTGGGGAAATGTT -> TAAGAGTGGGGAAATGTTG
GTAAGCCACCGGTACACGT -> TAAGCCACCGGTACACGTG
GTAAGCGAGGGAGCAATCG -> TAAGCGAGGGAGCAATCGT
GTAAGCTCTCACTCTTCGG -> TAAGCTCTCACTCTTCGGA
GTACAATCTTCGTTCTAGT -> TACAATCTTCGTTCTAGTC
GTACACGTGCCCGTCGCTT -> TACACGTGCCCGTCGCTTC
GTACAGAATTCGCCAAATT -> TACAGAATTCGCCAAATTA
GTACATTGCCCTTCGTCCG -> TACATTGCCCTTCGTCCGC
GTACCATATGGTATTTTGC -> TACCATATGGTATTTTGCG
GTACCGGAGTAGATACTGT -> TACCGGAGTAGATACTGTC
GTACCTGCATTCTTTAGTT -> TACCTGCATTCTTTAGTTG
GTACCTTCTTTGCCTGGTA -> TACCTTCTTTGCCTGGTAA
GTACGTTTTTGCTGTCTGG -> TACGTTTTTGCTGTCTGGG
GTACTAACTACAAGAGTTA -> TACTAACTACAAGAGTTAA
GTACTAAGCGATGATCGTC -> TACTAAGCGATGATCGTCG
GTACTAAGTATCAGAACCG -> TACTAAGTATCAGAACCGT
GTACTACCGCCGGACACAA -> TACTACCGCCGGACACAAC
GTACTACCGCGTACCATAT -> TACTACCGCGTACCATATG
GTACTACCGCGTCAGTTCA -> TACTACCGCGTCAGTTCAC
GTACTACCGCTTAAGATAT -> TACTACCGCTTAAGATATA
GTACTCACGATGTGCCCAA -> TACTCACGATGTGCCCAAC
GTAGACGCGCACAGCAATC -> TAGACGCGCACAGCAATCT
GTAGATACTGTCGGTATAG -> TAGATACTGTCGGTATAGG
GTAGCCCAACATGCTGTGG -> TAGCCCAACATGCTGTGGT
GTAGGGCCACCCCATCAAT -> TAGGGCCACCCCATCAATT
GTAGGTAGTCCATCGTTCC -> TAGGTAGTCCATCGTTCCC
GTAGTCCATCGTTCCCAGC -> TAGTCCATCGTTCCCAGCA
GTAGTCGACAAGACACGAT -> TAGTCGACAAGACACGATC
GTATAAATGGCTGTACGTT -> TATAAATGGCTGTACGTTT
GTATACCACCCTCCCTTCC -> TATACCACCCTCCCTTCCA
GTATAGGTTGTACTAAGTA -> TATAGGTTGTACTAAGTAT
GTATATGGCGTCTAAGGCC -> TATATGGCGTCTAAGGCCA
GTATCAGAACCGTATATGG -> TATCAGAACCGTATATGGC
GTATCATCCCTTTAACGGC -> TATCATCCCTTTAACGGCT
GTATCCGTGTAGTCGACAA -> TATCCGTGTAGTCGACAAG
GTATCGCGAACTAGCGGCC -> TATCGCGAACTAGCGGCCT
GTATCTCGCGTTGCTTTTT -> TATCTCGCGTTGCTTTTTA
GTATCTCTAGCTGCCTGAC -> TATCTCTAGCTGCCTGACG
GTATCTGATTTCCCCAGGA -> TATCTGATTTCCCCAGGAT
GTATGCGTGTTCTGTGGTT -> TATGCGTGTTCTGTGGTTC
GTATGGCCTTGCGAACAGA -> TATGGCCTTGCGAACAGAG
GTATTCTTGTACTACCGCC -> TATTCTTGTACTACCGCCG
GTATTCTTGTACTACCGCG -> TATTCTTGTACTACCGCGT,TATTCTTGTACTACCGCGT
GTATTCTTGTACTACCGCT -> TATTCTTGTACTACCGCTT
GTATTTTGCGAAGGGTATG -> TATTTTGCGAAGGGTATGC
GTCAAAAAGACACTTGCCC -> TCAAAAAGACACTTGCCCG
GTCAAACCAGGACCGTTAT -> TCAAACCAGGACCGTTATC
GTCAAGCCCATGTATTCTT -> TCAAGCCCATGTATTCTTG
GTCACGACAGCACATGTAC -> TCACGACAGCACATGTACT
GTCAGTAGGTAGTCCATCG -> TCAGTAGGTAGTCCATCGT
GTCAGTTCACGACAAGCGT -> TCAGTTCACGACAAGCGTC
GTCCAAAGGGAGCTACAAG -> TCCAAAGGGAGCTACAAGA
GTCCATCGTTCCCAGCACG -> TCCATCGTTCCCAGCACGG
GTCCCGGACTCATTGGAGA -> TCCCGGACTCATTGGAGAG
GTCCGCTCTGTTCAATGCT -> TCCGCTCTGTTCAATGCTG
GTCCGTGAGGCTACATCTA -> TCCGTGAGGCTACATCTAC
GTCGACAAGACACGATCGC -> TCGACAAGACACGATCGCC
GTCGACGACGTCTAAGCAG -> TCGACGACGTCTAAGCAGT
GTCGAGCTAAAGCCGCAAC -> TCGAGCTAAAGCCGCAACG
GTCGAGTATAAATGGCTGT -> TCGAGTATAAATGGCTGTA
GTCGATCTGCCTGATTAAT -> TCGATCTGCCTGATTAATT
GTCGATTTGCAACTTTTGT -> TCGATTTGCAACTTTTGTA
GTCGCGTTCATCAAGTCAA -> TCGCGTTCATCAAGTCAAA
GTCGCTCATAACTGATACC -> TCGCTCATAACTGATACCC
GTCGCTGCACTTAGAGCTG -> TCGCTGCACTTAGAGCTGC
GTCGCTTCTTGAATTGTAT -> TCGCTTCTTGAATTGTATC
GTCGGCAATCAAGCCGGCA -> TCGGCAATCAAGCCGGCAC
GTCGGTATAGGTTGTACTA -> TCGGTATAGGTTGTACTAA
GTCGTGCCAGACAAACCGG -> TCGTGCCAGACAAACCGGT
GTCTAAGCAGTCCAAAGGG -> TCTAAGCAGTCCAAAGGGA
GTCTAAGGCCACGAAAAGG -> TCTAAGGCCACGAAAAGGC
GTCTAAGTTGTACCGGAGT -> TCTAAGTTGTACCGGAGTA
GTCTACAAGAGTTAAGAGC -> TCTACAAGAGTTAAGAGCA
GTCTATCCTACAAGAGTTA -> TCTATCCTACAAGAGTTAA
GTCTCAACATCAGCCGGTT -> TCTCAACATCAGCCGGTTG
GTCTCTCGAGTGCCGCGTT -> TCTCTCGAGTGCCGCGTTA
GTCTGGGAGCGCACGTAAA -> TCTGGGAGCGCACGTAAAG
GTCTGGGGATAGCATTAAT -> TCTGGGGATAGCATTAATC
GTGAAAATGGAGACTCAAA -> TGAAAATGGAGACTCAAAC
GTGAGCCAGCGGGCCGGGC -> TGAGCCAGCGGGCCGGGCT
GTGAGGCTACATCTACCGA -> TGAGGCTACATCTACCGAT
GTGATCGTAGACGCGCACA -> TGATCGTAGACGCGCACAG
GTGCAACTAACGGCCCAAC -> TGCAACTAACGGCCCAACC
GTGCACACTACTGAACAAT -> TGCACACTACTGAACAATT
GTGCCAGACAAACCGGTAG -> TGCCAGACAAACCGGTAGC
GTGCCCAACAAGAAGTCGA -> TGCCCAACAAGAAGTCGAC
GTGCCCGTCGCTTCTTGAA -> TGCCCGTCGCTTCTTGAAT
GTGCCGCGTTATACGCAAT -> TGCCGCGTTATACGCAATA
GTGCGAACTGCACCCCCAA -> TGCGAACTGCACCCCCAAA
GTGCGCATAGGGTACCTTC -> TGCGCATAGGGTACCTTCT
GTGCTCGGATGGACTGGTG -> TGCTCGGATGGACTGGTGC
GTGGCCTGTGGCGGGCAGA -> TGGCCTGTGGCGGGCAGAA
GTGGCGGGCAGAAAGTCAA -> TGGCGGGCAGAAAGTCAAA
GTGGGGAAATGTTGCCAGA -> TGGGGAAATGTTGCCAGAG
GTGGTATACCACCCTCCCT -> TGGTATACCACCCTCCCTT
GTGGTATGGCCTTGCGAAC -> TGGTATGGCCTTGCGAACA
GTGGTTAGGCCATAAAGCA -> TGGTTAGGCCATAAAGCAC
GTGGTTCTCCAAGTCGATT -> TGGTTCTCCAAGTCGATTT
GTGGTTTCTGCTTCAAAGC -> TGGTTTCTGCTTCAAAGCG
GTGTACAGAATTCGCCAAA -> TGTACAGAATTCGCCAAAT
GTGTACTAAGCGATGATCG -> TGTACTAAGCGATGATCGT
GTGTAGTCGACAAGACACG -> TGTAGTCGACAAGACACGA
GTGTATTCTTGTACTACCG -> TGTATTCTTGTACTACCGC
GTGTGCGCATAGGGTACCT -> TGTGCGCATAGGGTACCTT
GTGTGGTTTCTGCTTCAAA -> TGTGGTTTCTGCTTCAAAG
GTGTTCTGTGGTTCTCCAA -> TGTTCTGTGGTTCTCCAAG
GTTAAGAGCAAGTCAAGCC -> TTAAGAGCAAGTCAAGCCC
GTTAAGAGCACCCTATATT -> TTAAGAGCACCCTATATTC
GTTAAGAGCAGCTCCCGGC -> TTAAGAGCAGCTCCCGGCC
GTTAAGAGCATGGTTCCCC -> TTAAGAGCATGGTTCCCCA
GTTACAGAGTCGGCAATCA -> TTACAGAGTCGGCAATCAA
GTTACGTCAGTAGGTAGTC -> TTACGTCAGTAGGTAGTCC
GTTAGATCGGTTTGGGGCG -> TTAGATCGGTTTGGGGCGA
GTTAGATGTGATCGTAGAC -> TTAGATGTGATCGTAGACG
GTTAGGCCATAAAGCACGA -> TTAGGCCATAAAGCACGAG
GTTATACGCAATAGCAGTT -> TTATACGCAATAGCAGTTA
GTTATCAGAGGATACCCGT -> TTATCAGAGGATACCCGTG
GTTCAATGCTGCAGCCAAC -> TTCAATGCTGCAGCCAACA
GTTCACGACAAGCGTCTCA -> TTCACGACAAGCGTCTCAA
GTTCAGATCGTCTATCCTA -> TTCAGATCGTCTATCCTAC
GTTCATCAAGTCAAACCAG -> TTCATCAAGTCAAACCAGG
GTTCATCTAATCTGTTCGC -> TTCATCTAATCTGTTCGCG
GTTCCCAGCACGGATTTAA -> TTCCCAGCACGGATTTAAA
GTTCCCCAGTGTATTCTTG -> TTCCCCAGTGTATTCTTGT
GTTCGACGCAAGTCGTGCC -> TTCGACGCAAGTCGTGCCA
GTTCGCGGATGTGTGCGCA -> TTCGCGGATGTGTGCGCAT
GTTCTAGTCTGGGGATAGC -> TTCTAGTCTGGGGATAGCA
GTTCTCCAAGTCGATTTGC -> TTCTCCAAGTCGATTTGCA
GTTCTGGGTTTGTAAGCCA -> TTCTGGGTTTGTAAGCCAC
GTTCTGTGGTTCTCCAAGT -> TTCTGTGGTTCTCCAAGTC
GTTGAAACCGCCCGAGGGG -> TTGAAACCGCCCGAGGGGT
GTTGCCAGAGAGAGTGCAA -> TTGCCAGAGAGAGTGCAAC
GTTGCCTTGAGTTGAAACC -> TTGCCTTGAGTTGAAACCG
GTTGCTTTTTACGGGTGAG -> TTGCTTTTTACGGGTGAGC
GTTGGATCAGTTACGTCAG -> TTGGATCAGTTACGTCAGT
GTTGGCCAGGCGGCGAACG -> TTGGCCAGGCGGCGAACGA
GTTGTACCGGAGTAGATAC -> TTGTACCGGAGTAGATACT
GTTGTACTAAGTATCAGAA -> TTGTACTAAGTATCAGAAC
GTTGTGCGAACTGCACCCC -> TTGTGCGAACTGCACCCCC
GTTTCGACGTGCTCGGATG -> TTTCGACGTGCTCGGATGG
GTTTCTGCTTCAAAGCGGG -> TTTCTGCTTCAAAGCGGGA
GTTTGGGGCGAAGGGTCGC -> TTTGGGGCGAAGGGTCGCT
GTTTGTAAGCCACCGGTAC -> TTTGTAAGCCACCGGTACA
GTTTTTGCTGTCTGGGAGC -> TTTTTGCTGTCTGGGAGCG
TAAAAGTGTACAGAATTCG -> AAAAGTGTACAGAATTCGC
TAAACGATCATCTTCATCT -> AAACGATCATCTTCATCTG
TAAACTATGCGCGATCCTA -> AAACTATGCGCGATCCTAC
TAAAGAAGTCCCGGACTCA -> AAAGAAGTCCCGGACTCAT
TAAAGATTTGCAGGGAAAA -> AAAGATTTGCAGGGAAAAA
TAAAGCACGAGACATAACT -> AAAGCACGAGACATAACTA
TAAAGCCGCAACGAGGAAG -> AAAGCCGCAACGAGGAAGT
TAAAGTGTACTAAGCGATG -> AAAGTGTACTAAGCGATGA
TAAATGGCTGTACGTTTTT -> AAATGGCTGTACGTTTTTG
TAACCGGACCTTTGGACCA -> AACCGGACCTTTGGACCAA
TAACGGCCCAACCCAACTG -> AACGGCCCAACCCAACTGT
TAACGGCTACACGGTCACG -> AACGGCTACACGGTCACGA
TAACTAAAGTGTACTAAGC -> AACTAAAGTGTACTAAGCG
TAACTACAAGAGTTAAGAG -> AACTACAAGAGTTAAGAGC
TAACTGATACCCAAAAATG -> AACTGATACCCAAAAATGG
TAACTGTACAATCTTCGTT -> AACTGTACAATCTTCGTTC
TAAGAGCAAGTCAAGCCCA -> AAGAGCAAGTCAAGCCCAT
TAAGAGCACCCTATATTCA -> AAGAGCACCCTATATTCAT
TAAGAGCAGCTCCCGGCCC -> AAGAGCAGCTCCCGGCCCT
TAAGAGCATGGTTCCCCAG -> AAGAGCATGGTTCCCCAGT
TAAGAGTGGGGAAATGTTG -> AAGAGTGGGGAAATGTTGC
TAAGATATAGTATCATCCC -> AAGATATAGTATCATCCCT
TAAGCAGTCCAAAGGGAGC -> AAGCAGTCCAAAGGGAGCT
TAAGCCACCGGTACACGTG -> AAGCCACCGGTACACGTGC
TAAGCCTCCTACAACACTT -> AAGCCTCCTACAACACTTC
TAAGCGAGGGAGCAATCGT -> AAGCGAGGGAGCAATCGTA
TAAGCGATGATCGTCGAGC -> AAGCGATGATCGTCGAGCT
TAAGCTCTCACTCTTCGGA -> AAGCTCTCACTCTTCGGAG
TAAGGCCACGAAAAGGCTA -> AAGGCCACGAAAAGGCTAG
TAAGGTAAGCGAGGGAGCA -> AAGGTAAGCGAGGGAGCAA
TAAGTATCAGAACCGTATA -> AAGTATCAGAACCGTATAT
TAAGTTGTACCGGAGTAGA -> AAGTTGTACCGGAGTAGAT
TAATCCGGCTCACGTTACA -> AATCCGGCTCACGTTACAG
TAATCGAGCTAGCGGGCTA -> AATCGAGCTAGCGGGCTAG
TAATCTGTTCGCGGATGTG -> AATCTGTTCGCGGATGTGT
TAATGTAAGCTCTCACTCT -> AATGTAAGCTCTCACTCTT
TAATTATTAAACTATGCGC -> AATTATTAAACTATGCGCG
TACAACACTTCGCATAGTA -> ACAACACTTCGCATAGTAG
TACAACGCTGAGGCTCCGG -> ACAACGCTGAGGCTCCGGA
TACAAGAGTTAAGAGCAAG -> ACAAGAGTTAAGAGCAAGT
TACAAGAGTTAAGAGCACC -> ACAAGAGTTAAGAGCACCC
TACAAGAGTTAAGAGCAGC -> ACAAGAGTTAAGAGCAGCT
TACAAGAGTTAAGAGCATG -> ACAAGAGTTAAGAGCATGG
TACAATCTTCGTTCTAGTC -> ACAATCTTCGTTCTAGTCT
TACACGGTCACGACAGCAC -> ACACGGTCACGACAGCACA
TACACGGTTAGATGTGATC -> ACACGGTTAGATGTGATCG
TACACGTGCCCGTCGCTTC -> ACACGTGCCCGTCGCTTCT
TACAGAATTCGCCAAATTA -> ACAGAATTCGCCAAATTAA
TACAGAGTCGGCAATCAAG -> ACAGAGTCGGCAATCAAGC
TACATCTACCGATCGCCTG -> ACATCTACCGATCGCCTGC
TACATTGCCCTTCGTCCGC -> ACATTGCCCTTCGTCCGCT
TACCACCCTCCCTTCCATG -> ACCACCCTCCCTTCCATGA
TACCAGGAGTTTCGACGTG -> ACCAGGAGTTTCGACGTGC
TACCATATGGTATTTTGCG -> ACCATATGGTATTTTGCGA
TACCCAAAAATGGTTCGAC -> ACCCAAAAATGGTTCGACG
TACCCGTGCACACTACTGA -> ACCCGTGCACACTACTGAA
TACCGATCGCCTGCCTCCC -> ACCGATCGCCTGCCTCCCG
TACCGCCGGACACAACCAT -> ACCGCCGGACACAACCATA
TACCGCGTACCATATGGTA -> ACCGCGTACCATATGGTAT
TACCGCGTCAGTTCACGAC -> ACCGCGTCAGTTCACGACA
TACCGCTTAAGATATAGTA -> ACCGCTTAAGATATAGTAT
TACCGGAGTAGATACTGTC -> ACCGGAGTAGATACTGTCG
TACCTGCATTCTTTAGTTG -> ACCTGCATTCTTTAGTTGT
TACCTTCTTTGCCTGGTAA -> ACCTTCTTTGCCTGGTAAG
TACGCAATAGCAGTTAGAT -> ACGCAATAGCAGTTAGATC
TACGGGTGAGCCAGCGGGC -> ACGGGTGAGCCAGCGGGCC
TACGTCAGTAGGTAGTCCA -> ACGTCAGTAGGTAGTCCAT
TACGTTTTTGCTGTCTGGG -> ACGTTTTTGCTGTCTGGGA
TACTAACTACAAGAGTTAA -> ACTAACTACAAGAGTTAAG
TACTAAGCGATGATCGTCG -> ACTAAGCGATGATCGTCGA
TACTAAGTATCAGAACCGT -> ACTAAGTATCAGAACCGTA
TACTACCGCCGGACACAAC -> ACTACCGCCGGACACAACC
TACTACCGCGTACCATATG -> ACTACCGCGTACCATATGG
TACTACCGCGTCAGTTCAC -> ACTACCGCGTCAGTTCACG
TACTACCGCTTAAGATATA -> ACTACCGCTTAAGATATAG
TACTCACGATGTGCCCAAC -> ACTCACGATGTGCCCAACA
TACTGAACAATTTAATCCG -> ACTGAACAATTTAATCCGG
TACTGATCGATCGTCTACA -> ACTGATCGATCGTCTACAA
TACTGTCGGTATAGGTTGT -> ACTGTCGGTATAGGTTGTA
TAGACGCGCACAGCAATCT -> AGACGCGCACAGCAATCTG
TAGAGCTGCTAATGTAAGC -> AGAGCTGCTAATGTAAGCT
TAGATACTGTCGGTATAGG -> AGATACTGTCGGTATAGGT
TAGATCGGTTTGGGGCGAA -> AGATCGGTTTGGGGCGAAG
TAGATGTGATCGTAGACGC -> AGATGTGATCGTAGACGCG
TAGCACGCCTATTAAAGAA -> AGCACGCCTATTAAAGAAG
TAGCAGTTAGATCGGTTTG -> AGCAGTTAGATCGGTTTGG
TAGCATTAATCGAGCTAGC -> AGCATTAATCGAGCTAGCG
TAGCCCAACATGCTGTGGT -> AGCCCAACATGCTGTGGTT
TAGCGACATCACAATGCAA -> AGCGACATCACAATGCAAG
TAGCGGCCTCCGCCCTGCT -> AGCGGCCTCCGCCCTGCTT
TAGCGGGCTAGTTCTGGGT -> AGCGGGCTAGTTCTGGGTT
TAGCGGGTCGAGTATAAAT -> AGCGGGTCGAGTATAAATG
TAGCTGCCTGACGACAAGG -> AGCTGCCTGACGACAAGGA
TAGGCCATAAAGCACGAGA -> AGGCCATAAAGCACGAGAC
TAGGGCCACCCCATCAATT -> AGGGCCACCCCATCAATTC
TAGGGTACCTTCTTTGCCT -> AGGGTACCTTCTTTGCCTG
TAGGTAGTCCATCGTTCCC -> AGGTAGTCCATCGTTCCCA
TAGGTGTGGTTTCTGCTTC -> AGGTGTGGTTTCTGCTTCA
TAGGTTGTACTAAGTATCA -> AGGTTGTACTAAGTATCAG
TAGTAGGGCCACCCCATCA -> AGTAGGGCCACCCCATCAA
TAGTATCATCCCTTTAACG -> AGTATCATCCCTTTAACGG
TAGTATCGCGAACTAGCGG -> AGTATCGCGAACTAGCGGC
TAGTCCATCGTTCCCAGCA -> AGTCCATCGTTCCCAGCAC
TAGTCGACAAGACACGATC -> AGTCGACAAGACACGATCG
TAGTCTGGGGATAGCATTA -> AGTCTGGGGATAGCATTAA
TAGTTCTGGGTTTGTAAGC -> AGTTCTGGGTTTGTAAGCC
TAGTTGTGCGAACTGCACC -> AGTTGTGCGAACTGCACCC
TATAAATGGCTGTACGTTT -> ATAAATGGCTGTACGTTTT
TATACCACCCTCCCTTCCA -> ATACCACCCTCCCTTCCAT
TATACGCAATAGCAGTTAG -> ATACGCAATAGCAGTTAGA
TATAGGTTGTACTAAGTAT -> ATAGGTTGTACTAAGTATC
TATAGTATCATCCCTTTAA -> ATAGTATCATCCCTTTAAC
TATATGGCGTCTAAGGCCA -> ATATGGCGTCTAAGGCCAC
TATATTCATGTATTCTTGT -> ATATTCATGTATTCTTGTA
TATCAGAACCGTATATGGC -> ATCAGAACCGTATATGGCG
TATCAGAGGATACCCGTGC -> ATCAGAGGATACCCGTGCA
TATCATCCCTTTAACGGCT -> ATCATCCCTTTAACGGCTA
TATCCGTGTAGTCGACAAG -> ATCCGTGTAGTCGACAAGA
TATCCTACAAGAGTTAAGA -> ATCCTACAAGAGTTAAGAG
TATCGCGAACTAGCGGCCT -> ATCGCGAACTAGCGGCCTC
TATCTCGCGTTGCTTTTTA -> ATCTCGCGTTGCTTTTTAC
TATCTCTAGCTGCCTGACG -> ATCTCTAGCTGCCTGACGA
TATCTGATTTCCCCAGGAT -> ATCTGATTTCCCCAGGATA
TATCTTTGGCTGGTACATT -> ATCTTTGGCTGGTACATTG
TATGCGCGATCCTACCAGG -> ATGCGCGATCCTACCAGGA
TATGCGTGTTCTGTGGTTC -> ATGCGTGTTCTGTGGTTCT
TATGCTTGCTTATCTTTGG -> ATGCTTGCTTATCTTTGGC
TATGGCCTTGCGAACAGAG -> ATGGCCTTGCGAACAGAGA
TATGGCGTCTAAGGCCACG -> ATGGCGTCTAAGGCCACGA
TATGGTATTTTGCGAAGGG -> ATGGTATTTTGCGAAGGGT
TATTAAACTATGCGCGATC -> ATTAAACTATGCGCGATCC
TATTAAAGAAGTCCCGGAC -> ATTAAAGAAGTCCCGGACT
TATTAAGGTAAGCGAGGGA -> ATTAAGGTAAGCGAGGGAG
TATTATGCTTGCTTATCTT -> ATTATGCTTGCTTATCTTT
TATTCATGTATTCTTGTAC -> ATTCATGTATTCTTGTACT
TATTCTTGTACTACCGCCG -> ATTCTTGTACTACCGCCGG
TATTCTTGTACTACCGCGT -> ATTCTTGTACTACCGCGTA,ATTCTTGTACTACCGCGTC
TATTCTTGTACTACCGCTT -> ATTCTTGTACTACCGCTTA
TATTTTGCGAAGGGTATGC -> ATTTTGCGAAGGGTATGCG
TCAAAAAGACACTTGCCCG -> CAAAAAGACACTTGCCCGC
TCAAACCAGGACCGTTATC -> CAAACCAGGACCGTTATCA
TCAAACCATAGTATCGCGA -> CAAACCATAGTATCGCGAA
TCAAAGCGGGAGCCTGGTC -> CAAAGCGGGAGCCTGGTCT
TCAACATCAGCCGGTTGGC -> CAACATCAGCCGGTTGGCC
TCAAGCCCATGTATTCTTG -> CAAGCCCATGTATTCTTGT
TCAAGCCGGCACAGAGTCC -> CAAGCCGGCACAGAGTCCG
TCAAGCGTAACCGGACCTT -> CAAGCGTAACCGGACCTTT
TCAAGTCAAACCAGGACCG -> CAAGTCAAACCAGGACCGT
TCAATGCTGCAGCCAACAC -> CAATGCTGCAGCCAACACT
TCAATTCACATTACAACGC -> CAATTCACATTACAACGCT
TCACAATGCAAGTCGATCT -> CACAATGCAAGTCGATCTG
TCACATTACAACGCTGAGG -> CACATTACAACGCTGAGGC
TCACGACAAGCGTCTCAAC -> CACGACAAGCGTCTCAACA
TCACGACAGCACATGTACT -> CACGACAGCACATGTACTA
TCACGATGTGCCCAACAAG -> CACGATGTGCCCAACAAGA
TCACGTTACAGAGTCGGCA -> CACGTTACAGAGTCGGCAA
TCACTCTTCGGAGGAGGCA -> CACTCTTCGGAGGAGGCAG
TCAGAACCGTATATGGCGT -> CAGAACCGTATATGGCGTC
TCAGAGGATACCCGTGCAC -> CAGAGGATACCCGTGCACA
TCAGATCGTCTATCCTACA -> CAGATCGTCTATCCTACAA
TCAGCAGCCGAGGCATCCT -> CAGCAGCCGAGGCATCCTG
TCAGCCGGTTGGCCAGGCG -> CAGCCGGTTGGCCAGGCGG
TCAGGTTGCCTTGAGTTGA -> CAGGTTGCCTTGAGTTGAA
TCAGTAGGTAGTCCATCGT -> CAGTAGGTAGTCCATCGTT
TCAGTTACGTCAGTAGGTA -> CAGTTACGTCAGTAGGTAG
TCAGTTCACGACAAGCGTC -> CAGTTCACGACAAGCGTCT
TCATAACTGATACCCAAAA -> CATAACTGATACCCAAAAA
TCATCAAGTCAAACCAGGA -> CATCAAGTCAAACCAGGAC
TCATCCCTTTAACGGCTAC -> CATCCCTTTAACGGCTACA
TCATCTAATCTGTTCGCGG -> CATCTAATCTGTTCGCGGA
TCATCTGGACCTTATTATG -> CATCTGGACCTTATTATGC
TCATCTTCATCTGGACCTT -> CATCTTCATCTGGACCTTA
TCATGTATTCTTGTACTAC -> CATGTATTCTTGTACTACC
TCATTGGAGAGACAAGCCA -> CATTGGAGAGACAAGCCAT
TCCAAAGGGAGCTACAAGA -> CCAAAGGGAGCTACAAGAG
TCCAAGTCGATTTGCAACT -> CCAAGTCGATTTGCAACTT
TCCATCGTTCCCAGCACGG -> CCATCGTTCCCAGCACGGA
TCCATGAGATGGCCGCTGA -> CCATGAGATGGCCGCTGAC
TCCCACAGCCTGTTGGATC -> CCCACAGCCTGTTGGATCA
TCCCAGCACGGATTTAAAA -> CCCAGCACGGATTTAAAAG
TCCCCAGGATAGCGGGTCG -> CCCCAGGATAGCGGGTCGA
TCCCCAGTGTATTCTTGTA -> CCCCAGTGTATTCTTGTAC
TCCCGGACTCATTGGAGAG -> CCCGGACTCATTGGAGAGA
TCCCGGCCCTGTATTCTTG -> CCCGGCCCTGTATTCTTGT
TCCCGTATCTCGCGTTGCT -> CCCGTATCTCGCGTTGCTT
TCCCTTCCATGAGATGGCC -> CCCTTCCATGAGATGGCCG
TCCCTTTAACGGCTACACG -> CCCTTTAACGGCTACACGG
TCCGCCCTGCTTGGTCTAA -> CCGCCCTGCTTGGTCTAAG
TCCGCTCTGTTCAATGCTG -> CCGCTCTGTTCAATGCTGC
TCCGGATCCCACAGCCTGT -> CCGGATCCCACAGCCTGTT
TCCGGCTCACGTTACAGAG -> CCGGCTCACGTTACAGAGT
TCCGTGAGGCTACATCTAC -> CCGTGAGGCTACATCTACC
TCCGTGTAGTCGACAAGAC -> CCGTGTAGTCGACAAGACA
TCCTACAACACTTCGCATA -> CCTACAACACTTCGCATAG
TCCTACAAGAGTTAAGAGC -> CCTACAAGAGTTAAGAGCA
TCCTACCAGGAGTTTCGAC -> CCTACCAGGAGTTTCGACG
TCCTGTGGCCTGTGGCGGG -> CCTGTGGCCTGTGGCGGGC
TCGACAAGACACGATCGCC -> CGACAAGACACGATCGCCG
TCGACGACGTCTAAGCAGT -> CGACGACGTCTAAGCAGTC
TCGACGCAAGTCGTGCCAG -> CGACGCAAGTCGTGCCAGA
TCGACGTGCTCGGATGGAC -> CGACGTGCTCGGATGGACT
TCGAGCTAAAGCCGCAACG -> CGAGCTAAAGCCGCAACGA
TCGAGCTAGCGGGCTAGTT -> CGAGCTAGCGGGCTAGTTC
TCGAGTATAAATGGCTGTA -> CGAGTATAAATGGCTGTAC
TCGAGTGCCGCGTTATACG -> CGAGTGCCGCGTTATACGC
TCGATCGTCTACAAGAGTT -> CGATCGTCTACAAGAGTTA
TCGATCTGCCTGATTAATT -> CGATCTGCCTGATTAATTA
TCGATTGCAACGTACTCAC -> CGATTGCAACGTACTCACG
TCGATTTGCAACTTTTGTA -> CGATTTGCAACTTTTGTAA
TCGCATAGTAGGGCCACCC -> CGCATAGTAGGGCCACCCC
TCGCCAAATTAAACGATCA -> CGCCAAATTAAACGATCAT
TCGCCGGAGAATGTGAAAA -> CGCCGGAGAATGTGAAAAT
TCGCCTGCCTCCCGTATCT -> CGCCTGCCTCCCGTATCTC
TCGCGAACTAGCGGCCTCC -> CGCGAACTAGCGGCCTCCG
TCGCGGAGTCGCTCATAAC -> CGCGGAGTCGCTCATAACT
TCGCGGATGTGTGCGCATA -> CGCGGATGTGTGCGCATAG
TCGCGTTCATCAAGTCAAA -> CGCGTTCATCAAGTCAAAC
TCGCGTTGCTTTTTACGGG -> CGCGTTGCTTTTTACGGGT
TCGCTCATAACTGATACCC -> CGCTCATAACTGATACCCA
TCGCTGCACTTAGAGCTGC -> CGCTGCACTTAGAGCTGCT
TCGCTTCTTGAATTGTATC -> CGCTTCTTGAATTGTATCC
TCGGAGGAGGCAGACTCGC -> CGGAGGAGGCAGACTCGCG
TCGGATGGACTGGTGCGAT -> CGGATGGACTGGTGCGATT
TCGGCAATCAAGCCGGCAC -> CGGCAATCAAGCCGGCACA
TCGGTATAGGTTGTACTAA -> CGGTATAGGTTGTACTAAG
TCGGTTTGGGGCGAAGGGT -> CGGTTTGGGGCGAAGGGTC
TCGTAGACGCGCACAGCAA -> CGTAGACGCGCACAGCAAT
TCGTATCTGATTTCCCCAG -> CGTATCTGATTTCCCCAGG
TCGTCCGCTCTGTTCAATG -> CGTCCGCTCTGTTCAATGC
TCGTCGAGCTAAAGCCGCA -> CGTCGAGCTAAAGCCGCAA
TCGTCTACAAGAGTTAAGA -> CGTCTACAAGAGTTAAGAG
TCGTCTATCCTACAAGAGT -> CGTCTATCCTACAAGAGTT
TCGTGCCAGACAAACCGGT -> CGTGCCAGACAAACCGGTA
TCGTGGTATACCACCCTCC -> CGTGGTATACCACCCTCCC
TCGTTCCCAGCACGGATTT -> CGTTCCCAGCACGGATTTA
TCGTTCTAGTCTGGGGATA -> CGTTCTAGTCTGGGGATAG
TCTAAGCAGTCCAAAGGGA -> CTAAGCAGTCCAAAGGGAG
TCTAAGGCCACGAAAAGGC -> CTAAGGCCACGAAAAGGCT
TCTAAGTTGTACCGGAGTA -> CTAAGTTGTACCGGAGTAG
TCTAATCTGTTCGCGGATG -> CTAATCTGTTCGCGGATGT
TCTACAAGAGTTAAGAGCA -> CTACAAGAGTTAAGAGCAT
TCTACCGATCGCCTGCCTC -> CTACCGATCGCCTGCCTCC
TCTAGCTGCCTGACGACAA -> CTAGCTGCCTGACGACAAG
TCTAGTCTGGGGATAGCAT -> CTAGTCTGGGGATAGCATT
TCTATCCTACAAGAGTTAA -> CTATCCTACAAGAGTTAAG
TCTCAACATCAGCCGGTTG -> CTCAACATCAGCCGGTTGG
TCTCACTCTTCGGAGGAGG -> CTCACTCTTCGGAGGAGGC
TCTCCAAGTCGATTTGCAA -> CTCCAAGTCGATTTGCAAC
TCTCGAGTGCCGCGTTATA -> CTCGAGTGCCGCGTTATAC
TCTCGCGTTGCTTTTTACG -> CTCGCGTTGCTTTTTACGG
TCTCTAGCTGCCTGACGAC -> CTCTAGCTGCCTGACGACA
TCTCTCGAGTGCCGCGTTA -> CTCTCGAGTGCCGCGTTAT
TCTGATTTCCCCAGGATAG -> CTGATTTCCCCAGGATAGC
TCTGCCTGATTAATTATTA -> CTGCCTGATTAATTATTAA
TCTGCTTCAAAGCGGGAGC -> CTGCTTCAAAGCGGGAGCC
TCTGGACCTTATTATGCTT -> CTGGACCTTATTATGCTTG
TCTGGGAGCGCACGTAAAG -> CTGGGAGCGCACGTAAAGA
TCTGGGCGAGGACATATTA -> CTGGGCGAGGACATATTAA
TCTGGGGATAGCATTAATC -> CTGGGGATAGCATTAATCG
TCTGGGTTTGTAAGCCACC -> CTGGGTTTGTAAGCCACCG
TCTGTGGTTCTCCAAGTCG -> CTGTGGTTCTCCAAGTCGA
TCTGTTCAATGCTGCAGCC -> CTGTTCAATGCTGCAGCCA
TCTGTTCGCGGATGTGTGC -> CTGTTCGCGGATGTGTGCG
TCTTCATCTGGACCTTATT -> CTTCATCTGGACCTTATTA
TCTTCGGAGGAGGCAGACT -> CTTCGGAGGAGGCAGACTC
TCTTCGTTCTAGTCTGGGG -> CTTCGTTCTAGTCTGGGGA
TCTTGAATTGTATCCGTGT -> CTTGAATTGTATCCGTGTA
TCTTGTACTACCGCCGGAC -> CTTGTACTACCGCCGGACA
TCTTGTACTACCGCGTACC -> CTTGTACTACCGCGTACCA
TCTTGTACTACCGCGTCAG -> CTTGTACTACCGCGTCAGT
TCTTGTACTACCGCTTAAG -> CTTGTACTACCGCTTAAGA
TCTTTAGTTGTGCGAACTG -> CTTTAGTTGTGCGAACTGC
TCTTTGCCTGGTAAGAGTG -> CTTTGCCTGGTAAGAGTGG
TCTTTGGCTGGTACATTGC -> CTTTGGCTGGTACATTGCC
TGAAAATGGAGACTCAAAC -> GAAAATGGAGACTCAAACC
TGAAACCGCCCGAGGGGTT -> GAAACCGCCCGAGGGGTTC
TGAACAATTTAATCCGGCT -> GAACAATTTAATCCGGCTC
TGAATTGTATCCGTGTAGT -> GAATTGTATCCGTGTAGTC
TGACCTAGGTGTGGTTTCT -> GACCTAGGTGTGGTTTCTG
TGACGACAAGGAGCCTCAG -> GACGACAAGGAGCCTCAGC
TGAGATGGCCGCTGACCTA -> GAGATGGCCGCTGACCTAG
TGAGCCAGCGGGCCGGGCT -> GAGCCAGCGGGCCGGGCTG
TGAGGCTACATCTACCGAT -> GAGGCTACATCTACCGATC
TGAGGCTCCGGATCCCACA -> GAGGCTCCGGATCCCACAG
TGAGTTGAAACCGCCCGAG -> GAGTTGAAACCGCCCGAGG
TGATACCCAAAAATGGTTC -> GATACCCAAAAATGGTTCG
TGATCGATCGTCTACAAGA -> GATCGATCGTCTACAAGAG
TGATCGTAGACGCGCACAG -> GATCGTAGACGCGCACAGC
TGATCGTCGAGCTAAAGCC -> GATCGTCGAGCTAAAGCCG
TGATTAATTATTAAACTAT -> GATTAATTATTAAACTATG
TGATTTCCCCAGGATAGCG -> GATTTCCCCAGGATAGCGG
TGCAACGTACTCACGATGT -> GCAACGTACTCACGATGTG
TGCAACTAACGGCCCAACC -> GCAACTAACGGCCCAACCC
TGCAACTTTTGTAACTGTA -> GCAACTTTTGTAACTGTAC
TGCAAGTCGATCTGCCTGA -> GCAAGTCGATCTGCCTGAT
TGCACACTACTGAACAATT -> GCACACTACTGAACAATTT
TGCACCCCCAAAGCAAAAT -> GCACCCCCAAAGCAAAATT
TGCACTTAGAGCTGCTAAT -> GCACTTAGAGCTGCTAATG
TGCAGCCAACACTGTATCT -> GCAGCCAACACTGTATCTC
TGCAGGGAAAAAGAGAAAC -> GCAGGGAAAAAGAGAAACT
TGCATTCTTTAGTTGTGCG -> GCATTCTTTAGTTGTGCGA
TGCCAGACAAACCGGTAGC -> GCCAGACAAACCGGTAGCC
TGCCAGAGAGAGTGCAACT -> GCCAGAGAGAGTGCAACTA
TGCCCAACAAGAAGTCGAC -> GCCCAACAAGAAGTCGACG
TGCCCGCGTTCAGATCGTC -> GCCCGCGTTCAGATCGTCT
TGCCCGTCGCTTCTTGAAT -> GCCCGTCGCTTCTTGAATT
TGCCCTTCGTCCGCTCTGT -> GCCCTTCGTCCGCTCTGTT
TGCCGCGTTATACGCAATA -> GCCGCGTTATACGCAATAG
TGCCTCCCGTATCTCGCGT -> GCCTCCCGTATCTCGCGTT
TGCCTGACGACAAGGAGCC -> GCCTGACGACAAGGAGCCT
TGCCTGATTAATTATTAAA -> GCCTGATTAATTATTAAAC
TGCCTGGTAAGAGTGGGGA -> GCCTGGTAAGAGTGGGGAA
TGCCTTGAGTTGAAACCGC -> GCCTTGAGTTGAAACCGCC
TGCGAACAGAGAATTCGAT -> GCGAACAGAGAATTCGATT
TGCGAACTGCACCCCCAAA -> GCGAACTGCACCCCCAAAG
TGCGAAGGGTATGCGTGTT -> GCGAAGGGTATGCGTGTTC
TGCGCATAGGGTACCTTCT -> GCGCATAGGGTACCTTCTT
TGCGCGATCCTACCAGGAG -> GCGCGATCCTACCAGGAGT
TGCGTGTTCTGTGGTTCTC -> GCGTGTTCTGTGGTTCTCC
TGCTAATGTAAGCTCTCAC -> GCTAATGTAAGCTCTCACT
TGCTCGGATGGACTGGTGC -> GCTCGGATGGACTGGTGCG
TGCTGCAGCCAACACTGTA -> GCTGCAGCCAACACTGTAT
TGCTGTCTGGGAGCGCACG -> GCTGTCTGGGAGCGCACGT
TGCTGTGGTTAGGCCATAA -> GCTGTGGTTAGGCCATAAA
TGCTTATCTTTGGCTGGTA -> GCTTATCTTTGGCTGGTAC
TGCTTCAAAGCGGGAGCCT -> GCTTCAAAGCGGGAGCCTG
TGCTTGCTTATCTTTGGCT -> GCTTGCTTATCTTTGGCTG
TGCTTGGTCTAAGTTGTAC -> GCTTGGTCTAAGTTGTACC
TGCTTTTTACGGGTGAGCC -> GCTTTTTACGGGTGAGCCA
TGGACCAACACAATTCGTG -> GGACCAACACAATTCGTGG
TGGACCTTATTATGCTTGC -> GGACCTTATTATGCTTGCT
TGGAGACTCAAACCATAGT -> GGAGACTCAAACCATAGTA
TGGAGAGACAAGCCATACA -> GGAGAGACAAGCCATACAC
TGGATCAGTTACGTCAGTA -> GGATCAGTTACGTCAGTAG
TGGCCAGGCGGCGAACGAT -> GGCCAGGCGGCGAACGATA
TGGCCGCTGACCTAGGTGT -> GGCCGCTGACCTAGGTGTG
TGGCCTGTGGCGGGCAGAA -> GGCCTGTGGCGGGCAGAAA
TGGCCTTGCGAACAGAGAA -> GGCCTTGCGAACAGAGAAT
TGGCGGGCAGAAAGTCAAA -> GGCGGGCAGAAAGTCAAAA
TGGCGTCTAAGGCCACGAA -> GGCGTCTAAGGCCACGAAA
TGGCTGGTACATTGCCCTT -> GGCTGGTACATTGCCCTTC
TGGCTGTACGTTTTTGCTG -> GGCTGTACGTTTTTGCTGT
TGGGAGCGCACGTAAAGAT -> GGGAGCGCACGTAAAGATT
TGGGCGAGGACATATTAAG -> GGGCGAGGACATATTAAGG
TGGGGAAATGTTGCCAGAG -> GGGGAAATGTTGCCAGAGA
TGGGGATAGCATTAATCGA -> GGGGATAGCATTAATCGAG
TGGGGCGAAGGGTCGCTGC -> GGGGCGAAGGGTCGCTGCA
TGGGTGGTATGGCCTTGCG -> GGGTGGTATGGCCTTGCGA
TGGGTTTGTAAGCCACCGG -> GGGTTTGTAAGCCACCGGT
TGGTAAGAGTGGGGAAATG -> GGTAAGAGTGGGGAAATGT
TGGTACATTGCCCTTCGTC -> GGTACATTGCCCTTCGTCC
TGGTATACCACCCTCCCTT -> GGTATACCACCCTCCCTTC
TGGTATGGCCTTGCGAACA -> GGTATGGCCTTGCGAACAG
TGGTATTTTGCGAAGGGTA -> GGTATTTTGCGAAGGGTAT
TGGTCTAAGTTGTACCGGA -> GGTCTAAGTTGTACCGGAG
TGGTCTCTCGAGTGCCGCG -> GGTCTCTCGAGTGCCGCGT
TGGTTAGGCCATAAAGCAC -> GGTTAGGCCATAAAGCACG
TGGTTCCCCAGTGTATTCT -> GGTTCCCCAGTGTATTCTT
TGGTTCGACGCAAGTCGTG -> GGTTCGACGCAAGTCGTGC
TGGTTCTCCAAGTCGATTT -> GGTTCTCCAAGTCGATTTG
TGGTTTCTGCTTCAAAGCG -> GGTTTCTGCTTCAAAGCGG
TGTAACTGTACAATCTTCG -> GTAACTGTACAATCTTCGT
TGTAAGCCACCGGTACACG -> GTAAGCCACCGGTACACGT
TGTAAGCTCTCACTCTTCG -> GTAAGCTCTCACTCTTCGG
TGTACAATCTTCGTTCTAG -> GTACAATCTTCGTTCTAGT
TGTACAGAATTCGCCAAAT -> GTACAGAATTCGCCAAATT
TGTACCGGAGTAGATACTG -> GTACCGGAGTAGATACTGT
TGTACGTTTTTGCTGTCTG -> GTACGTTTTTGCTGTCTGG
TGTACTAACTACAAGAGTT -> GTACTAACTACAAGAGTTA
TGTACTAAGCGATGATCGT -> GTACTAAGCGATGATCGTC
TGTACTAAGTATCAGAACC -> GTACTAAGTATCAGAACCG
TGTACTACCGCCGGACACA -> GTACTACCGCCGGACACAA
TGTACTACCGCGTACCATA -> GTACTACCGCGTACCATAT
TGTACTACCGCGTCAGTTC -> GTACTACCGCGTCAGTTCA
TGTACTACCGCTTAAGATA -> GTACTACCGCTTAAGATAT
TGTAGTCGACAAGACACGA -> GTAGTCGACAAGACACGAT
TGTATCCGTGTAGTCGACA -> GTATCCGTGTAGTCGACAA
TGTATCTCTAGCTGCCTGA -> GTATCTCTAGCTGCCTGAC
TGTATTCTTGTACTACCGC -> GTATTCTTGTACTACCGCC,GTATTCTTGTACTACCGCT,GTATTCTTGTACTACCGCG,GTATTCTTGTACTACCGCG
TGTCGCGTTCATCAAGTCA -> GTCGCGTTCATCAAGTCAA
TGTCGGTATAGGTTGTACT -> GTCGGTATAGGTTGTACTA
TGTCTGGGAGCGCACGTAA -> GTCTGGGAGCGCACGTAAA
TGTGAAAATGGAGACTCAA -> GTGAAAATGGAGACTCAAA
TGTGATCGTAGACGCGCAC -> GTGATCGTAGACGCGCACA
TGTGCCCAACAAGAAGTCG -> GTGCCCAACAAGAAGTCGA
TGTGCGAACTGCACCCCCA -> GTGCGAACTGCACCCCCAA
TGTGCGCATAGGGTACCTT -> GTGCGCATAGGGTACCTTC
TGTGGCCTGTGGCGGGCAG -> GTGGCCTGTGGCGGGCAGA
TGTGGCGGGCAGAAAGTCA -> GTGGCGGGCAGAAAGTCAA
TGTGGTTAGGCCATAAAGC -> GTGGTTAGGCCATAAAGCA
TGTGGTTCTCCAAGTCGAT -> GTGGTTCTCCAAGTCGATT
TGTGGTTTCTGCTTCAAAG -> GTGGTTTCTGCTTCAAAGC
TGTGTGCGCATAGGGTACC -> GTGTGCGCATAGGGTACCT
TGTTCAATGCTGCAGCCAA -> GTTCAATGCTGCAGCCAAC
TGTTCGCGGATGTGTGCGC -> GTTCGCGGATGTGTGCGCA
TGTTCTGTGGTTCTCCAAG -> GTTCTGTGGTTCTCCAAGT
TGTTGCCAGAGAGAGTGCA -> GTTGCCAGAGAGAGTGCAA
TGTTGGATCAGTTACGTCA -> GTTGGATCAGTTACGTCAG
TTAAAAGTGTACAGAATTC -> TAAAAGTGTACAGAATTCG
TTAAACGATCATCTTCATC -> TAAACGATCATCTTCATCT
TTAAACTATGCGCGATCCT -> TAAACTATGCGCGATCCTA
TTAAAGAAGTCCCGGACTC -> TAAAGAAGTCCCGGACTCA
TTAACGGCTACACGGTCAC -> TAACGGCTACACGGTCACG
TTAAGAGCAAGTCAAGCCC -> TAAGAGCAAGTCAAGCCCA
TTAAGAGCACCCTATATTC -> TAAGAGCACCCTATATTCA
TTAAGAGCAGCTCCCGGCC -> TAAGAGCAGCTCCCGGCCC
TTAAGAGCATGGTTCCCCA -> TAAGAGCATGGTTCCCCAG
TTAAGATATAGTATCATCC -> TAAGATATAGTATCATCCC
TTAAGGTAAGCGAGGGAGC -> TAAGGTAAGCGAGGGAGCA
TTAATCCGGCTCACGTTAC -> TAATCCGGCTCACGTTACA
TTAATCGAGCTAGCGGGCT -> TAATCGAGCTAGCGGGCTA
TTAATTATTAAACTATGCG -> TAATTATTAAACTATGCGC
TTACAACGCTGAGGCTCCG -> TACAACGCTGAGGCTCCGG
TTACAGAGTCGGCAATCAA -> TACAGAGTCGGCAATCAAG
TTACGGGTGAGCCAGCGGG -> TACGGGTGAGCCAGCGGGC
TTACGTCAGTAGGTAGTCC -> TACGTCAGTAGGTAGTCCA
TTAGAGCTGCTAATGTAAG -> TAGAGCTGCTAATGTAAGC
TTAGATCGGTTTGGGGCGA -> TAGATCGGTTTGGGGCGAA
TTAGATGTGATCGTAGACG -> TAGATGTGATCGTAGACGC
TTAGGCCATAAAGCACGAG -> TAGGCCATAAAGCACGAGA
TTAGTTGTGCGAACTGCAC -> TAGTTGTGCGAACTGCACC
TTATACGCAATAGCAGTTA -> TATACGCAATAGCAGTTAG
TTATCAGAGGATACCCGTG -> TATCAGAGGATACCCGTGC
TTATCTTTGGCTGGTACAT -> TATCTTTGGCTGGTACATT
TTATGCTTGCTTATCTTTG -> TATGCTTGCTTATCTTTGG
TTATTAAACTATGCGCGAT -> TATTAAACTATGCGCGATC
TTATTATGCTTGCTTATCT -> TATTATGCTTGCTTATCTT
TTCAAAGCGGGAGCCTGGT -> TCAAAGCGGGAGCCTGGTC
TTCAATGCTGCAGCCAACA -> TCAATGCTGCAGCCAACAC
TTCACATTACAACGCTGAG -> TCACATTACAACGCTGAGG
TTCACGACAAGCGTCTCAA -> TCACGACAAGCGTCTCAAC
TTCAGATCGTCTATCCTAC -> TCAGATCGTCTATCCTACA
TTCAGGTTGCCTTGAGTTG -> TCAGGTTGCCTTGAGTTGA
TTCATCAAGTCAAACCAGG -> TCATCAAGTCAAACCAGGA
TTCATCTAATCTGTTCGCG -> TCATCTAATCTGTTCGCGG
TTCATCTGGACCTTATTAT -> TCATCTGGACCTTATTATG
TTCATGTATTCTTGTACTA -> TCATGTATTCTTGTACTAC
TTCCATGAGATGGCCGCTG -> TCCATGAGATGGCCGCTGA
TTCCCAGCACGGATTTAAA -> TCCCAGCACGGATTTAAAA
TTCCCCAGGATAGCGGGTC -> TCCCCAGGATAGCGGGTCG
TTCCCCAGTGTATTCTTGT -> TCCCCAGTGTATTCTTGTA
TTCGACGCAAGTCGTGCCA -> TCGACGCAAGTCGTGCCAG
TTCGACGTGCTCGGATGGA -> TCGACGTGCTCGGATGGAC
TTCGATTGCAACGTACTCA -> TCGATTGCAACGTACTCAC
TTCGCATAGTAGGGCCACC -> TCGCATAGTAGGGCCACCC
TTCGCCAAATTAAACGATC -> TCGCCAAATTAAACGATCA
TTCGCGGATGTGTGCGCAT -> TCGCGGATGTGTGCGCATA
TTCGGAGGAGGCAGACTCG -> TCGGAGGAGGCAGACTCGC
TTCGTCCGCTCTGTTCAAT -> TCGTCCGCTCTGTTCAATG
TTCGTGGTATACCACCCTC -> TCGTGGTATACCACCCTCC
TTCGTTCTAGTCTGGGGAT -> TCGTTCTAGTCTGGGGATA
TTCTAGTCTGGGGATAGCA -> TCTAGTCTGGGGATAGCAT
TTCTCCAAGTCGATTTGCA -> TCTCCAAGTCGATTTGCAA
TTCTGCTTCAAAGCGGGAG -> TCTGCTTCAAAGCGGGAGC
TTCTGGGTTTGTAAGCCAC -> TCTGGGTTTGTAAGCCACC
TTCTGTGGTTCTCCAAGTC -> TCTGTGGTTCTCCAAGTCG
TTCTTGAATTGTATCCGTG -> TCTTGAATTGTATCCGTGT
TTCTTGTACTACCGCCGGA -> TCTTGTACTACCGCCGGAC
TTCTTGTACTACCGCGTAC -> TCTTGTACTACCGCGTACC
TTCTTGTACTACCGCGTCA -> TCTTGTACTACCGCGTCAG
TTCTTGTACTACCGCTTAA -> TCTTGTACTACCGCTTAAG
TTCTTTAGTTGTGCGAACT -> TCTTTAGTTGTGCGAACTG
TTCTTTGCCTGGTAAGAGT -> TCTTTGCCTGGTAAGAGTG
TTGAAACCGCCCGAGGGGT -> TGAAACCGCCCGAGGGGTT
TTGAATTGTATCCGTGTAG -> TGAATTGTATCCGTGTAGT
TTGAGTTGAAACCGCCCGA -> TGAGTTGAAACCGCCCGAG
TTGCAACGTACTCACGATG -> TGCAACGTACTCACGATGT
TTGCAACTTTTGTAACTGT -> TGCAACTTTTGTAACTGTA
TTGCAGGGAAAAAGAGAAA -> TGCAGGGAAAAAGAGAAAC
TTGCCAGAGAGAGTGCAAC -> TGCCAGAGAGAGTGCAACT
TTGCCCGCGTTCAGATCGT -> TGCCCGCGTTCAGATCGTC
TTGCCCTTCGTCCGCTCTG -> TGCCCTTCGTCCGCTCTGT
TTGCCTGGTAAGAGTGGGG -> TGCCTGGTAAGAGTGGGGA
TTGCCTTGAGTTGAAACCG -> TGCCTTGAGTTGAAACCGC
TTGCGAACAGAGAATTCGA -> TGCGAACAGAGAATTCGAT
TTGCGAAGGGTATGCGTGT -> TGCGAAGGGTATGCGTGTT
TTGCTGTCTGGGAGCGCAC -> TGCTGTCTGGGAGCGCACG
TTGCTTATCTTTGGCTGGT -> TGCTTATCTTTGGCTGGTA
TTGCTTTTTACGGGTGAGC -> TGCTTTTTACGGGTGAGCC
TTGGACCAACACAATTCGT -> TGGACCAACACAATTCGTG
TTGGAGAGACAAGCCATAC -> TGGAGAGACAAGCCATACA
TTGGATCAGTTACGTCAGT -> TGGATCAGTTACGTCAGTA
TTGGCCAGGCGGCGAACGA -> TGGCCAGGCGGCGAACGAT
TTGGCTGGTACATTGCCCT -> TGGCTGGTACATTGCCCTT
TTGGGGCGAAGGGTCGCTG -> TGGGGCGAAGGGTCGCTGC
TTGGTCTAAGTTGTACCGG -> TGGTCTAAGTTGTACCGGA
TTGTAACTGTACAATCTTC -> TGTAACTGTACAATCTTCG
TTGTAAGCCACCGGTACAC -> TGTAAGCCACCGGTACACG
TTGTACCGGAGTAGATACT -> TGTACCGGAGTAGATACTG
TTGTACTAAGTATCAGAAC -> TGTACTAAGTATCAGAACC
TTGTACTACCGCCGGACAC -> TGTACTACCGCCGGACACA
TTGTACTACCGCGTACCAT -> TGTACTACCGCGTACCATA
TTGTACTACCGCGTCAGTT -> TGTACTACCGCGTCAGTTC
TTGTACTACCGCTTAAGAT -> TGTACTACCGCTTAAGATA
TTGTATCCGTGTAGTCGAC -> TGTATCCGTGTAGTCGACA
TTGTGCGAACTGCACCCCC -> TGTGCGAACTGCACCCCCA
TTTAAAAGTGTACAGAATT -> TTAAAAGTGTACAGAATTC
TTTAACGGCTACACGGTCA -> TTAACGGCTACACGGTCAC
TTTAATCCGGCTCACGTTA -> TTAATCCGGCTCACGTTAC
TTTACGGGTGAGCCAGCGG -> TTACGGGTGAGCCAGCGGG
TTTAGTTGTGCGAACTGCA -> TTAGTTGTGCGAACTGCAC
TTTCAGGTTGCCTTGAGTT -> TTCAGGTTGCCTTGAGTTG
TTTCCCCAGGATAGCGGGT -> TTCCCCAGGATAGCGGGTC
TTTCGACGTGCTCGGATGG -> TTCGACGTGCTCGGATGGA
TTTCTGCTTCAAAGCGGGA -> TTCTGCTTCAAAGCGGGAG
TTTGCAACTTTTGTAACTG -> TTGCAACTTTTGTAACTGT
TTTGCAGGGAAAAAGAGAA -> TTGCAGGGAAAAAGAGAAA
TTTGCCTGGTAAGAGTGGG -> TTGCCTGGTAAGAGTGGGG
TTTGCGAAGGGTATGCGTG -> TTGCGAAGGGTATGCGTGT
TTTGCTGTCTGGGAGCGCA -> TTGCTGTCTGGGAGCGCAC
TTTGGACCAACACAATTCG -> TTGGACCAACACAATTCGT
TTTGGCTGGTACATTGCCC -> TTGGCTGGTACATTGCCCT
TTTGGGGCGAAGGGTCGCT -> TTGGGGCGAAGGGTCGCTG
TTTGTAACTGTACAATCTT -> TTGTAACTGTACAATCTTC
TTTGTAAGCCACCGGTACA -> TTGTAAGCCACCGGTACAC
TTTTACGGGTGAGCCAGCG -> TTTACGGGTGAGCCAGCGG
TTTTGCGAAGGGTATGCGT -> TTTGCGAAGGGTATGCGTG
TTTTGCTGTCTGGGAGCGC -> TTTGCTGTCTGGGAGCGCA
TTTTGTAACTGTACAATCT -> TTTGTAACTGTACAATCTT
TTTTTACGGGTGAGCCAGC -> TTTTACGGGTGAGCCAGCG
TTTTTGCTGTCTGGGAGCG -> TTTTGCTGTCTGGGAGCGC
