AAAAACATCAT -> AAAACATCATA
AAAACACGGCA -> AAACACGGCAT
AAAACATCATA -> AAACATCATAA
AAAACTGGTGA -> AAACTGGTGAC
AAAAGGGGCAA -> AAAGGGGCAAC
AAAAGTCCATC -> AAAGTCCATCT
AAAAGTCCTTT -> AAAGTCCTTTC
AAAAGTTGCGT -> AAAGTTGCGTA
AAAATTGACCC -> AAATTGACCCA
AAAATTTAGCT -> AAATTTAGCTT
AAACAAAGGAG -> AACAAAGGAGA
AAACACACTGA -> AACACACTGAG
AAACACGGCAT -> AACACGGCATC
AAACATACGGC -> AACATACGGCA
AAACATCATAA -> AACATCATAAA
AAACCAATGCC -> AACCAATGCCT
AAACCCATTTG -> AACCCATTTGG
AAACTCATAGG -> AACTCATAGGG
AAACTGGTGAC -> AACTGGTGACC
AAACTTTCTGT -> AACTTTCTGTT
AAAGACAGTGA -> AAGACAGTGAC
AAAGCGACTAT -> AAGCGACTATC
AAAGGAGAGGA -> AAGGAGAGGAT
AAAGGGATTAT -> AAGGGATTATT
AAAGGGGCAAC -> AAGGGGCAACA
AAAGTCCATCT -> AAGTCCATCTT
AAAGTCCTTTC -> AAGTCCTTTCA
AAAGTTGCGTA -> AAGTTGCGTAA
AAATCTCTGGT -> AATCTCTGGTG
AAATGAACAGT -> AATGAACAGTA
AAATGCAATCG -> AATGCAATCGC
AAATGTACGCG -> AATGTACGCGA
AAATGTCAATG -> AATGTCAATGG
AAATTGACCCA -> AATTGACCCAT
AAATTGCTTAA -> AATTGCTTAAG
AAATTTAGCTT -> AATTTAGCTTA
AAATTTTTATA -> AATTTTTATAT
AACAAAGGAGA -> ACAAAGGAGAG
AACACACTGAG -> ACACACTGAGA
AACACGGCATC -> ACACGGCATCC
AACACGTTAAA -> ACACGTTAAAC
AACAGTAGAAT -> ACAGTAGAATT
AACATACGGCA -> ACATACGGCAT
AACATCATAAA -> ACATCATAAAG
AACATTGACGG -> ACATTGACGGA
AACCAATGCCT -> ACCAATGCCTT
AACCCATTTGG -> ACCCATTTGGG
AACCCCGAAGA -> ACCCCGAAGAA
AACCGAAAAGT -> ACCGAAAAGTC
AACCGGTAAGT -> ACCGGTAAGTT
AACCTAACACG -> ACCTAACACGT
AACCTCGATAT -> ACCTCGATATT
AACCTCTTTAC -> ACCTCTTTACC
AACCTTAGGAG -> ACCTTAGGAGA
AACGCGGAGCA -> ACGCGGAGCAA
AACGCGTCAGG -> ACGCGTCAGGG
AACGGCGTCAC -> ACGGCGTCACA
AACTATTACGG -> ACTATTACGGA
AACTCATAGGG -> ACTCATAGGGA
AACTCCAGAGC -> ACTCCAGAGCT
AACTCGGCAGT -> ACTCGGCAGTA
AACTCTTACAT -> ACTCTTACATC
AACTGCCATGC -> ACTGCCATGCA
AACTGGTGACC -> ACTGGTGACCA
AACTTTCTGTT -> ACTTTCTGTTG
AAGAACCTAAC -> AGAACCTAACA
AAGACACTACA -> AGACACTACAT
AAGACAGTGAC -> AGACAGTGACC
AAGACCCCGCG -> AGACCCCGCGT
AAGAGATTAGG -> AGAGATTAGGC
AAGATCTACGT -> AGATCTACGTA
AAGCAAGTGTA -> AGCAAGTGTAA
AAGCATCGATG -> AGCATCGATGC
AAGCGAATACT -> AGCGAATACTC
AAGCGACTATC -> AGCGACTATCA
AAGCGCGATCG -> AGCGCGATCGC
AAGCGGATTTT -> AGCGGATTTTT
AAGCTAAACTT -> AGCTAAACTTT
AAGCTCTCGTG -> AGCTCTCGTGA
AAGGAGAGGAT -> AGGAGAGGATT
AAGGGATTATT -> AGGGATTATTA
AAGGGGCAACA -> AGGGGCAACAT
AAGGTACACGA -> AGGTACACGAA
AAGGTTCTGAA -> AGGTTCTGAAT
AAGTACGTCGG -> AGTACGTCGGA
AAGTATGCACG -> AGTATGCACGG
AAGTCCATCTT -> AGTCCATCTTG
AAGTCCTTTCA -> AGTCCTTTCAA
AAGTGCATCTA -> AGTGCATCTAT
AAGTGCGACAA -> AGTGCGACAAC
AAGTGTAAGAG -> AGTGTAAGAGA
AAGTGTCACTC -> AGTGTCACTCA
AAGTTGCGTAA -> AGTTGCGTAAC
AAGTTGCTACA -> AGTTGCTACAC
AATAAACCAAT -> ATAAACCAATG
AATAAGCAAGT -> ATAAGCAAGTG
AATAAGGTTCT -> ATAAGGTTCTG
AATACAATATA -> ATACAATATAG
AATACTCTTTA -> ATACTCTTTAG
AATATAGCAAG -> ATATAGCAAGC
AATCAAGCGAA -> ATCAAGCGAAT
AATCCATGTTT -> ATCCATGTTTT
AATCCCGACAG -> ATCCCGACAGT
AATCGACTGTT -> ATCGACTGTTA
AATCGCTTCAG -> ATCGCTTCAGG
AATCTATCACG -> ATCTATCACGA
AATCTCTGGTG -> ATCTCTGGTGT
AATGAACAGTA -> ATGAACAGTAG
AATGATGTACG -> ATGATGTACGT
AATGCAATCGC -> ATGCAATCGCT
AATGCAGATCC -> ATGCAGATCCA
AATGCCTTCTG -> ATGCCTTCTGG
AATGGTTATCT -> ATGGTTATCTT
AATGTACGCGA -> ATGTACGCGAC
AATGTCAATGG -> ATGTCAATGGT
AATTACAAGAC -> ATTACAAGACC
AATTACGACTA -> ATTACGACTAC
AATTATTACCG -> ATTATTACCGC
AATTCAATTAC -> ATTCAATTACA
AATTGACCCAT -> ATTGACCCATG
AATTGCTTAAG -> ATTGCTTAAGC
AATTTAGCTTA -> ATTTAGCTTAT
AATTTTTATAT -> ATTTTTATATG
ACAAAGGAGAG -> CAAAGGAGAGG
ACAACCCCGAA -> CAACCCCGAAG
ACAACTATTAC -> CAACTATTACG
ACAAGACACTA -> CAAGACACTAC
ACAAGACCCCG -> CAAGACCCCGC
ACAAGTGCGAC -> CAAGTGCGACA
ACAATATAGCA -> CAATATAGCAA
ACACACTGAGA -> CACACTGAGAG
ACACAGTCCTC -> CACAGTCCTCT
ACACCAACGCG -> CACCAACGCGG
ACACGAATTAC -> CACGAATTACG
ACACGGCATCC -> CACGGCATCCT
ACACGTTAAAC -> CACGTTAAACC
ACACTACATAT -> CACTACATATC
ACACTGAGAGC -> CACTGAGAGCA
ACACTGCCGAT -> CACTGCCGATT
ACAGCATGACT -> CAGCATGACTT
ACAGTAGAATT -> CAGTAGAATTC
ACAGTAGGTTG -> CAGTAGGTTGG
ACAGTAGTACA -> CAGTAGTACAA
ACAGTCCTCTT -> CAGTCCTCTTG
ACAGTCGTTAG -> CAGTCGTTAGT
ACAGTGACCAC -> CAGTGACCACT
ACAGTGGAGCA -> CAGTGGAGCAA
ACAGTGGCAGT -> CAGTGGCAGTT
ACAGTGTCACA -> CAGTGTCACAG
ACATACGGCAT -> CATACGGCATG
ACATATCAGCT -> CATATCAGCTC
ACATATCTCAC -> CATATCTCACT
ACATCATAAAG -> CATCATAAAGC
ACATCCCATCA -> CATCCCATCAG
ACATCCTTTCA -> CATCCTTTCAT
ACATCGAAAAG -> CATCGAAAAGG
ACATCGCATGA -> CATCGCATGAC
ACATTGACGGA -> CATTGACGGAT
ACATTTTGTCT -> CATTTTGTCTC
ACCAACGCGGA -> CCAACGCGGAG
ACCAATGCCTT -> CCAATGCCTTC
ACCACACCAAC -> CCACACCAACG
ACCACTGTCGC -> CCACTGTCGCG
ACCAGATCATT -> CCAGATCATTT
ACCCAGCAGGT -> CCCAGCAGGTT
ACCCATGTCCT -> CCCATGTCCTT
ACCCATTTGGG -> CCCATTTGGGC
ACCCCGAAGAA -> CCCCGAAGAAC
ACCCCGCGTTA -> CCCCGCGTTAA
ACCCCTCAGTC -> CCCCTCAGTCT
ACCCCTTACGA -> CCCCTTACGAT
ACCCTCGTGGT -> CCCTCGTGGTC
ACCCTTGAAAA -> CCCTTGAAAAT
ACCGAAAAGTC -> CCGAAAAGTCC
ACCGACTCGTG -> CCGACTCGTGC
ACCGCACGACC -> CCGCACGACCG
ACCGCACTAGA -> CCGCACTAGAT
ACCGGTAAGTT -> CCGGTAAGTTG
ACCGTTTTACG -> CCGTTTTACGC
ACCTAACACGT -> CCTAACACGTT
ACCTCGATATT -> CCTCGATATTA
ACCTCTTTACC -> CCTCTTTACCC
ACCTGGGATCC -> CCTGGGATCCA
ACCTGGGGATC -> CCTGGGGATCA
ACCTTAGGAGA -> CCTTAGGAGAA
ACCTTCGGTTG -> CCTTCGGTTGA
ACCTTGAATGA -> CCTTGAATGAT
ACGAATTACGA -> CGAATTACGAC
ACGACCGTTTT -> CGACCGTTTTA
ACGACTACGTG -> CGACTACGTGA
ACGAGACTAAA -> CGAGACTAAAC
ACGAGGATCGT -> CGAGGATCGTG
ACGATCACCTG -> CGATCACCTGG
ACGCATCTCCA -> CGCATCTCCAC
ACGCATTCAGT -> CGCATTCAGTA
ACGCCAAGCTA -> CGCCAAGCTAA
ACGCCTTTCTC -> CGCCTTTCTCC
ACGCGACTACC -> CGCGACTACCT
ACGCGCCCTCC -> CGCGCCCTCCA
ACGCGGAGCAA -> CGCGGAGCAAG
ACGCGTCAGGG -> CGCGTCAGGGT
ACGCTATGTCA -> CGCTATGTCAG
ACGCTTACAAG -> CGCTTACAAGT
ACGCTTAGCTG -> CGCTTAGCTGG
ACGGACATCCT -> CGGACATCCTT
ACGGATTTAAG -> CGGATTTAAGC
ACGGATTTGCC -> CGGATTTGCCG
ACGGCATCCTA -> CGGCATCCTAT
ACGGCATGCGT -> CGGCATGCGTC
ACGGCGTCACA -> CGGCGTCACAG
ACGGCGTCCAA -> CGGCGTCCAAG
ACGGTCTCTAT -> CGGTCTCTATT
ACGGTGTGTTT -> CGGTGTGTTTT
ACGTAGAATGC -> CGTAGAATGCA
ACGTATTGCTA -> CGTATTGCTAC
ACGTCGGAGAT -> CGTCGGAGATT
ACGTGAATCGA -> CGTGAATCGAC
ACGTGAGCACC -> CGTGAGCACCT
ACGTTAAACCC -> CGTTAAACCCA
ACTAAACTCAT -> CTAAACTCATA
ACTACATATCA -> CTACATATCAG
ACTACCCTCGT -> CTACCCTCGTG
ACTACCTTGAA -> CTACCTTGAAT
ACTACGGCGTC -> CTACGGCGTCC
ACTACGTGAGC -> CTACGTGAGCA
ACTAGATGATT -> CTAGATGATTC
ACTAGCGCTAA -> CTAGCGCTAAC
ACTAGGACTGT -> CTAGGACTGTT
ACTATCATAAT -> CTATCATAATC
ACTATTACGGA -> CTATTACGGAT
ACTCAGCACAT -> CTCAGCACATC
ACTCATAGGGA -> CTCATAGGGAC
ACTCCAGAGCT -> CTCCAGAGCTT
ACTCCAGATTT -> CTCCAGATTTT
ACTCGGCAGTA -> CTCGGCAGTAC
ACTCGTGCGTC -> CTCGTGCGTCC
ACTCTCGAGGG -> CTCTCGAGGGT
ACTCTTACATC -> CTCTTACATCC
ACTCTTTAGCC -> CTCTTTAGCCA
ACTGAGAGCAA -> CTGAGAGCAAA
ACTGCCATGCA -> CTGCCATGCAA
ACTGCCGATTA -> CTGCCGATTAG
ACTGGCGAGGC -> CTGGCGAGGCG
ACTGGTGACCA -> CTGGTGACCAG
ACTGTCGCGGG -> CTGTCGCGGGG
ACTGTTAAACA -> CTGTTAAACAA
ACTGTTGCGGG -> CTGTTGCGGGT
ACTTATCGCGT -> CTTATCGCGTG
ACTTTACATTT -> CTTTACATTTT
ACTTTAGCAAA -> CTTTAGCAAAT
ACTTTCTGTTG -> CTTTCTGTTGT
ACTTTTTTTGT -> CTTTTTTTGTA
AGAAACACACT -> GAAACACACTG
AGAAAGGGATT -> GAAAGGGATTA
AGAACCTAACA -> GAACCTAACAC
AGAAGATCTAC -> GAAGATCTACG
AGAATCTATCA -> GAATCTATCAC
AGAATGCAGAT -> GAATGCAGATC
AGAATTCAATT -> GAATTCAATTA
AGACACTACAT -> GACACTACATA
AGACAGTGACC -> GACAGTGACCA
AGACATCGCAT -> GACATCGCATG
AGACCCCGCGT -> GACCCCGCGTT
AGACTAAACTC -> GACTAAACTCA
AGAGATTAGGC -> GAGATTAGGCG
AGAGCAAATTT -> GAGCAAATTTT
AGAGCTCGTAC -> GAGCTCGTACC
AGAGCTTTCCG -> GAGCTTTCCGC
AGAGGACGCAT -> GAGGACGCATC
AGAGGATTGCA -> GAGGATTGCAC
AGAGGCATTAT -> GAGGCATTATG
AGAGGCTGTAG -> GAGGCTGTAGA
AGAGTTTAATA -> GAGTTTAATAA
AGATCAATAAG -> GATCAATAAGC
AGATCATTTGA -> GATCATTTGAT
AGATCCACACT -> GATCCACACTG
AGATCTACGTA -> GATCTACGTAG
AGATGATTCAC -> GATGATTCACA
AGATTAGGCGG -> GATTAGGCGGT
AGATTCTCTAG -> GATTCTCTAGA
AGATTTCACAG -> GATTTCACAGT
AGATTTTTCGA -> GATTTTTCGAC
AGCAAAACACG -> GCAAAACACGG
AGCAAATTGCT -> GCAAATTGCTT
AGCAAATTTTT -> GCAAATTTTTA
AGCAACTCCAG -> GCAACTCCAGA
AGCAAGCGCGA -> GCAAGCGCGAT
AGCAAGCGGAT -> GCAAGCGGATT
AGCAAGTGTAA -> GCAAGTGTAAG
AGCACATCGAA -> GCACATCGAAA
AGCACCTTCGG -> GCACCTTCGGT
AGCACGCCTTT -> GCACGCCTTTC
AGCAGGTTTCC -> GCAGGTTTCCA
AGCATCGATGC -> GCATCGATGCC
AGCATGACTTT -> GCATGACTTTT
AGCCACTCCAG -> GCCACTCCAGA
AGCCATGCACC -> GCCATGCACCC
AGCCGATCCGA -> GCCGATCCGAT
AGCCTGCGTGG -> GCCTGCGTGGT
AGCGAATACTC -> GCGAATACTCT
AGCGACTATCA -> GCGACTATCAT
AGCGCAAGTGC -> GCGCAAGTGCA
AGCGCATGTAG -> GCGCATGTAGG
AGCGCGATCGC -> GCGCGATCGCG
AGCGCTAACCT -> GCGCTAACCTC
AGCGGATTTTT -> GCGGATTTTTC
AGCTAAACTTT -> GCTAAACTTTC
AGCTCATTTGC -> GCTCATTTGCA
AGCTCGTACCG -> GCTCGTACCGA
AGCTCTCGTGA -> GCTCTCGTGAC
AGCTGCTACAG -> GCTGCTACAGT
AGCTGGAGATT -> GCTGGAGATTC
AGCTGGGTCCG -> GCTGGGTCCGG
AGCTTATATTA -> GCTTATATTAT
AGCTTTCCGCT -> GCTTTCCGCTT
AGCTTTGGCAC -> GCTTTGGCACG
AGGACCGCACT -> GGACCGCACTA
AGGACGCATCT -> GGACGCATCTC
AGGACTGTTGC -> GGACTGTTGCG
AGGAGAAACAC -> GGAGAAACACA
AGGAGAGGATT -> GGAGAGGATTG
AGGATCAAAGA -> GGATCAAAGAC
AGGATCGTGCA -> GGATCGTGCAC
AGGATTGCACT -> GGATTGCACTT
AGGCATTATGT -> GGCATTATGTG
AGGCGGTACCC -> GGCGGTACCCA
AGGCGTGACGG -> GGCGTGACGGT
AGGCTCGTCTC -> GGCTCGTCTCA
AGGCTGTAGAT -> GGCTGTAGATC
AGGGACTACCC -> GGGACTACCCT
AGGGATTATTA -> GGGATTATTAA
AGGGCCTCTAC -> GGGCCTCTACG
AGGGGCAACAT -> GGGGCAACATT
AGGGGCCGCTT -> GGGGCCGCTTA
AGGGTGTAGAA -> GGGTGTAGAAA
AGGGTGTATCC -> GGGTGTATCCA
AGGTACACGAA -> GGTACACGAAT
AGGTTCTGAAT -> GGTTCTGAATC
AGGTTGGTGAG -> GGTTGGTGAGG
AGGTTTCCAGT -> GGTTTCCAGTG
AGTAAGGTACA -> GTAAGGTACAC
AGTACAAGACA -> GTACAAGACAC
AGTACATATCT -> GTACATATCTC
AGTACCACACC -> GTACCACACCA
AGTACGCTTAC -> GTACGCTTACA
AGTACGTCGGA -> GTACGTCGGAG
AGTACTAGGAC -> GTACTAGGACT
AGTAGAATTCA -> GTAGAATTCAA
AGTAGCGCAAG -> GTAGCGCAAGT
AGTAGGTTGGT -> GTAGGTTGGTG
AGTAGTACAAG -> GTAGTACAAGA
AGTATGACGCT -> GTATGACGCTA
AGTATGCACGG -> GTATGCACGGT
AGTCCATCTTG -> GTCCATCTTGT
AGTCCTCTTGA -> GTCCTCTTGAA
AGTCCTTTCAA -> GTCCTTTCAAC
AGTCGAACCTT -> GTCGAACCTTA
AGTCGTTAGTA -> GTCGTTAGTAG
AGTCTCTCGCT -> GTCTCTCGCTC
AGTGACCACTG -> GTGACCACTGT
AGTGAGAAGAT -> GTGAGAAGATC
AGTGATTAAAC -> GTGATTAAACA
AGTGCATCTAT -> GTGCATCTATG
AGTGCCTTCAA -> GTGCCTTCAAA
AGTGCGACAAC -> GTGCGACAACT
AGTGGAGCAAC -> GTGGAGCAACT
AGTGGCAGAGG -> GTGGCAGAGGC
AGTGGCAGTTA -> GTGGCAGTTAG
AGTGTAAGAGA -> GTGTAAGAGAT
AGTGTCACAGC -> GTGTCACAGCA
AGTGTCACTCA -> GTGTCACTCAG
AGTTAGACATC -> GTTAGACATCG
AGTTATGAACC -> GTTATGAACCG
AGTTATGAACT -> GTTATGAACTG
AGTTGCGTAAC -> GTTGCGTAACT
AGTTGCTACAC -> GTTGCTACACA
AGTTGGCCGGG -> GTTGGCCGGGG
AGTTTAATAAG -> GTTTAATAAGG
ATAAACCAATG -> TAAACCAATGC
ATAAAGCGACT -> TAAAGCGACTA
ATAAGCAAGTG -> TAAGCAAGTGT
ATAAGGTTCTG -> TAAGGTTCTGA
ATAATCCCGAC -> TAATCCCGACA
ATACAATATAG -> TACAATATAGC
ATACGGCATGC -> TACGGCATGCG
ATACTCTTTAG -> TACTCTTTAGC
ATAGCAAGCGC -> TAGCAAGCGCG
ATAGCTGGAGA -> TAGCTGGAGAT
ATAGGGACTAC -> TAGGGACTACC
ATAGTAAGGTA -> TAGTAAGGTAC
ATATAGCAAGC -> TATAGCAAGCG
ATATCAGCTCA -> TATCAGCTCAT
ATATCTCACTA -> TATCTCACTAC
ATATGGAGCTG -> TATGGAGCTGC
ATATTATCTAC -> TATTATCTACC
ATATTATTAAA -> TATTATTAAAA
ATCAAAGACAG -> TCAAAGACAGT
ATCAAGCGAAT -> TCAAGCGAATA
ATCAATAAGCA -> TCAATAAGCAA
ATCACCTGGGG -> TCACCTGGGGA
ATCACGAGGAT -> TCACGAGGATC
ATCAGAATCTA -> TCAGAATCTAT
ATCAGCTCATT -> TCAGCTCATTT
ATCAGTACGCT -> TCAGTACGCTT
ATCATAAAGCG -> TCATAAAGCGA
ATCATAATCCC -> TCATAATCCCG
ATCATTTGATC -> TCATTTGATCT
ATCCACACTGC -> TCCACACTGCC
ATCCACAGTAG -> TCCACAGTAGG
ATCCACTCTCG -> TCCACTCTCGA
ATCCATGTTTT -> TCCATGTTTTC
ATCCCATCAGT -> TCCCATCAGTA
ATCCCGACAGT -> TCCCGACAGTC
ATCCGATTGTT -> TCCGATTGTTA
ATCCTATGCAA -> TCCTATGCAAC
ATCCTTTCATT -> TCCTTTCATTC
ATCGAAAAGGG -> TCGAAAAGGGG
ATCGACTGTTA -> TCGACTGTTAA
ATCGATGCCGT -> TCGATGCCGTC
ATCGCATGACG -> TCGCATGACGC
ATCGCGTGAAT -> TCGCGTGAATT
ATCGCGTGGGT -> TCGCGTGGGTA
ATCGCTTCAGG -> TCGCTTCAGGA
ATCGGTGGAAG -> TCGGTGGAAGT
ATCGTGCACCT -> TCGTGCACCTG
ATCTACCCTTG -> TCTACCCTTGA
ATCTACGTAGA -> TCTACGTAGAA
ATCTAGCCACT -> TCTAGCCACTC
ATCTATCACGA -> TCTATCACGAG
ATCTATGCTAT -> TCTATGCTATC
ATCTCACTACG -> TCTCACTACGG
ATCTCCACTAG -> TCTCCACTAGC
ATCTCCAGCGC -> TCTCCAGCGCA
ATCTCCGTTTT -> TCTCCGTTTTT
ATCTCTGGTGT -> TCTCTGGTGTG
ATCTTATAGCT -> TCTTATAGCTG
ATCTTGTTCGA -> TCTTGTTCGAC
ATGAAATGCAA -> TGAAATGCAAT
ATGAACAGTAG -> TGAACAGTAGA
ATGAACCGGTA -> TGAACCGGTAA
ATGAACTGCCA -> TGAACTGCCAT
ATGACGCTATG -> TGACGCTATGT
ATGACGCTTAG -> TGACGCTTAGC
ATGACTTTTTT -> TGACTTTTTTT
ATGAGTTATGA -> TGAGTTATGAA
ATGATGTACGT -> TGATGTACGTG
ATGATTCACAA -> TGATTCACAAC
ATGCAACGGCG -> TGCAACGGCGT
ATGCAACGGTT -> TGCAACGGTTT
ATGCAATCGCT -> TGCAATCGCTT
ATGCACCCCTC -> TGCACCCCTCA
ATGCACGGTGT -> TGCACGGTGTG
ATGCAGATCCA -> TGCAGATCCAC
ATGCCGTCTTG -> TGCCGTCTTGA
ATGCCTTCTGG -> TGCCTTCTGGC
ATGCGTCGTCC -> TGCGTCGTCCG
ATGCTATCGGT -> TGCTATCGGTG
ATGGAGCTGCT -> TGGAGCTGCTA
ATGGATTTGAT -> TGGATTTGATT
ATGGGAATACA -> TGGGAATACAA
ATGGTTATCTT -> TGGTTATCTTA
ATGTACGCGAC -> TGTACGCGACT
ATGTACGTGAA -> TGTACGTGAAT
ATGTAGGACCG -> TGTAGGACCGC
ATGTCAATGGT -> TGTCAATGGTT
ATGTCAGTTGG -> TGTCAGTTGGC
ATGTCCTTAGT -> TGTCCTTAGTC
ATGTGTCTTGA -> TGTGTCTTGAT
ATGTTTTCTCA -> TGTTTTCTCAG
ATTAAAAACAT -> TTAAAAACATC
ATTAAAATTTA -> TTAAAATTTAG
ATTAAACATAC -> TTAAACATACG
ATTACAAGACC -> TTACAAGACCC
ATTACCGCACG -> TTACCGCACGA
ATTACGACTAC -> TTACGACTACG
ATTACGGATTT -> TTACGGATTTG
ATTAGCACGCC -> TTAGCACGCCT
ATTAGGCGGTA -> TTAGGCGGTAC
ATTATCTACCC -> TTATCTACCCT
ATTATGTGTCT -> TTATGTGTCTT
ATTATTAAAAA -> TTATTAAAAAC
ATTATTAAAAT -> TTATTAAAATT
ATTATTACCGC -> TTATTACCGCA
ATTCAAATCTC -> TTCAAATCTCT
ATTCAATTACA -> TTCAATTACAA
ATTCACAACCC -> TTCACAACCCC
ATTCAGTACAT -> TTCAGTACATA
ATTCTCTAGAG -> TTCTCTAGAGC
ATTGACCCATG -> TTGACCCATGT
ATTGACGGATT -> TTGACGGATTT
ATTGAGAGGCT -> TTGAGAGGCTG
ATTGAGTTATG -> TTGAGTTATGA
ATTGCACTTTA -> TTGCACTTTAG
ATTGCAGTGAT -> TTGCAGTGATT
ATTGCTACGGA -> TTGCTACGGAC
ATTGCTTAAGC -> TTGCTTAAGCT
ATTGGCGGTGC -> TTGGCGGTGCT
ATTGGGCGGAG -> TTGGGCGGAGT
ATTGTTAAATG -> TTGTTAAATGT
ATTTAAGCATC -> TTTAAGCATCG
ATTTAGCTTAT -> TTTAGCTTATA
ATTTCACAGTA -> TTTCACAGTAG
ATTTGATCTCC -> TTTGATCTCCG
ATTTGATTGGG -> TTTGATTGGGC
ATTTGCATCTC -> TTTGCATCTCC
ATTTGCCGAGC -> TTTGCCGAGCA
ATTTGGGCCCG -> TTTGGGCCCGT
ATTTGTTCTAA -> TTTGTTCTAAT
ATTTTGTCTCG -> TTTTGTCTCGT
ATTTTTATATG -> TTTTTATATGG
ATTTTTCGAAA -> TTTTTCGAAAA
ATTTTTCGACG -> TTTTTCGACGC
CAAAACACGGC -> AAAACACGGCA
CAAAAGTCCTT -> AAAAGTCCTTT
CAAAGACAGTG -> AAAGACAGTGA
CAAAGGAGAGG -> AAAGGAGAGGA
CAAATCTCTGG -> AAATCTCTGGT
CAAATGAACAG -> AAATGAACAGT
CAAATTGCTTA -> AAATTGCTTAA
CAAATTTTTAT -> AAATTTTTATA
CAACATTGACG -> AACATTGACGG
CAACCCCGAAG -> AACCCCGAAGA
CAACGCGGAGC -> AACGCGGAGCA
CAACGCGTCAG -> AACGCGTCAGG
CAACGGCGTCA -> AACGGCGTCAC
CAACTATTACG -> AACTATTACGG
CAACTCCAGAG -> AACTCCAGAGC
CAAGACACTAC -> AAGACACTACA
CAAGACCCCGC -> AAGACCCCGCG
CAAGCGAATAC -> AAGCGAATACT
CAAGCGCGATC -> AAGCGCGATCG
CAAGCGGATTT -> AAGCGGATTTT
CAAGCTAAACT -> AAGCTAAACTT
CAAGTACGTCG -> AAGTACGTCGG
CAAGTGCATCT -> AAGTGCATCTA
CAAGTGCGACA -> AAGTGCGACAA
CAAGTGTAAGA -> AAGTGTAAGAG
CAATAAGCAAG -> AATAAGCAAGT
CAATATAGCAA -> AATATAGCAAG
CAATCCATGTT -> AATCCATGTTT
CAATCGCTTCA -> AATCGCTTCAG
CAATGCCTTCT -> AATGCCTTCTG
CAATGGTTATC -> AATGGTTATCT
CAATTACAAGA -> AATTACAAGAC
CACAACCCCGA -> ACAACCCCGAA
CACACCAACGC -> ACACCAACGCG
CACACTGAGAG -> ACACTGAGAGC
CACACTGCCGA -> ACACTGCCGAT
CACAGCATGAC -> ACAGCATGACT
CACAGTAGGTT -> ACAGTAGGTTG
CACAGTAGTAC -> ACAGTAGTACA
CACAGTCCTCT -> ACAGTCCTCTT
CACAGTGTCAC -> ACAGTGTCACA
CACATCGAAAA -> ACATCGAAAAG
CACCAACGCGG -> ACCAACGCGGA
CACCCCTCAGT -> ACCCCTCAGTC
CACCTGGGATC -> ACCTGGGATCC
CACCTGGGGAT -> ACCTGGGGATC
CACCTTCGGTT -> ACCTTCGGTTG
CACGAATTACG -> ACGAATTACGA
CACGACCGTTT -> ACGACCGTTTT
CACGAGGATCG -> ACGAGGATCGT
CACGCCTTTCT -> ACGCCTTTCTC
CACGGCATCCT -> ACGGCATCCTA
CACGGTGTGTT -> ACGGTGTGTTT
CACGTATTGCT -> ACGTATTGCTA
CACGTTAAACC -> ACGTTAAACCC
CACTACATATC -> ACTACATATCA
CACTACGGCGT -> ACTACGGCGTC
CACTAGATGAT -> ACTAGATGATT
CACTAGCGCTA -> ACTAGCGCTAA
CACTCAGCACA -> ACTCAGCACAT
CACTCCAGATT -> ACTCCAGATTT
CACTCTCGAGG -> ACTCTCGAGGG
CACTGAGAGCA -> ACTGAGAGCAA
CACTGCCGATT -> ACTGCCGATTA
CACTGTCGCGG -> ACTGTCGCGGG
CACTTTACATT -> ACTTTACATTT
CACTTTAGCAA -> ACTTTAGCAAA
CAGAATCTATC -> AGAATCTATCA
CAGAGCTTTCC -> AGAGCTTTCCG
CAGAGGACGCA -> AGAGGACGCAT
CAGAGGCATTA -> AGAGGCATTAT
CAGAGTTTAAT -> AGAGTTTAATA
CAGATCATTTG -> AGATCATTTGA
CAGATCCACAC -> AGATCCACACT
CAGATTTTTCG -> AGATTTTTCGA
CAGCACATCGA -> AGCACATCGAA
CAGCAGGTTTC -> AGCAGGTTTCC
CAGCATGACTT -> AGCATGACTTT
CAGCGCATGTA -> AGCGCATGTAG
CAGCTCATTTG -> AGCTCATTTGC
CAGGATCAAAG -> AGGATCAAAGA
CAGGGTGTATC -> AGGGTGTATCC
CAGGTTTCCAG -> AGGTTTCCAGT
CAGTACATATC -> AGTACATATCT
CAGTACCACAC -> AGTACCACACC
CAGTACGCTTA -> AGTACGCTTAC
CAGTAGAATTC -> AGTAGAATTCA
CAGTAGGTTGG -> AGTAGGTTGGT
CAGTAGTACAA -> AGTAGTACAAG
CAGTCCTCTTG -> AGTCCTCTTGA
CAGTCGTTAGT -> AGTCGTTAGTA
CAGTCTCTCGC -> AGTCTCTCGCT
CAGTGACCACT -> AGTGACCACTG
CAGTGATTAAA -> AGTGATTAAAC
CAGTGGAGCAA -> AGTGGAGCAAC
CAGTGGCAGAG -> AGTGGCAGAGG
CAGTGGCAGTT -> AGTGGCAGTTA
CAGTGTCACAG -> AGTGTCACAGC
CAGTTAGACAT -> AGTTAGACATC
CAGTTGGCCGG -> AGTTGGCCGGG
CATAAAGCGAC -> ATAAAGCGACT
CATAATCCCGA -> ATAATCCCGAC
CATACGGCATG -> ATACGGCATGC
CATAGGGACTA -> ATAGGGACTAC
CATAGTAAGGT -> ATAGTAAGGTA
CATATCAGCTC -> ATATCAGCTCA
CATATCTCACT -> ATATCTCACTA
CATCAGTACGC -> ATCAGTACGCT
CATCATAAAGC -> ATCATAAAGCG
CATCCCATCAG -> ATCCCATCAGT
CATCCTATGCA -> ATCCTATGCAA
CATCCTTTCAT -> ATCCTTTCATT
CATCGAAAAGG -> ATCGAAAAGGG
CATCGATGCCG -> ATCGATGCCGT
CATCGCATGAC -> ATCGCATGACG
CATCTATGCTA -> ATCTATGCTAT
CATCTCCACTA -> ATCTCCACTAG
CATCTCCAGCG -> ATCTCCAGCGC
CATCTTGTTCG -> ATCTTGTTCGA
CATGACGCTTA -> ATGACGCTTAG
CATGACTTTTT -> ATGACTTTTTT
CATGCAACGGT -> ATGCAACGGTT
CATGCACCCCT -> ATGCACCCCTC
CATGCGTCGTC -> ATGCGTCGTCC
CATGTAGGACC -> ATGTAGGACCG
CATGTCCTTAG -> ATGTCCTTAGT
CATGTTTTCTC -> ATGTTTTCTCA
CATTATGTGTC -> ATTATGTGTCT
CATTCAAATCT -> ATTCAAATCTC
CATTCAGTACA -> ATTCAGTACAT
CATTGACGGAT -> ATTGACGGATT
CATTGAGTTAT -> ATTGAGTTATG
CATTTGATCTC -> ATTTGATCTCC
CATTTGCATCT -> ATTTGCATCTC
CATTTGGGCCC -> ATTTGGGCCCG
CATTTTGTCTC -> ATTTTGTCTCG
CCAAAAGTCCT -> CAAAAGTCCTT
CCAACGCGGAG -> CAACGCGGAGC
CCAAGCTAAAC -> CAAGCTAAACT
CCAAGTACGTC -> CAAGTACGTCG
CCAATGCCTTC -> CAATGCCTTCT
CCACACCAACG -> CACACCAACGC
CCACACTGCCG -> CACACTGCCGA
CCACAGTAGGT -> CACAGTAGGTT
CCACTAGCGCT -> CACTAGCGCTA
CCACTCCAGAT -> CACTCCAGATT
CCACTCTCGAG -> CACTCTCGAGG
CCACTGTCGCG -> CACTGTCGCGG
CCAGAGCTTTC -> CAGAGCTTTCC
CCAGAGGACGC -> CAGAGGACGCA
CCAGATCATTT -> CAGATCATTTG
CCAGATTTTTC -> CAGATTTTTCG
CCAGCAGGTTT -> CAGCAGGTTTC
CCAGCGCATGT -> CAGCGCATGTA
CCAGTGGCAGA -> CAGTGGCAGAG
CCATCAGTACG -> CATCAGTACGC
CCATCTTGTTC -> CATCTTGTTCG
CCATGCAACGG -> CATGCAACGGT
CCATGCACCCC -> CATGCACCCCT
CCATGTCCTTA -> CATGTCCTTAG
CCATGTTTTCT -> CATGTTTTCTC
CCATTTGGGCC -> CATTTGGGCCC
CCCAGCAGGTT -> CCAGCAGGTTT
CCCATCAGTAC -> CCATCAGTACG
CCCATGTCCTT -> CCATGTCCTTA
CCCATTTGGGC -> CCATTTGGGCC
CCCCGAAGAAC -> CCCGAAGAACC
CCCCGCGTTAA -> CCCGCGTTAAC
CCCCGGTTCGT -> CCCGGTTCGTT
CCCCTCAGTCT -> CCCTCAGTCTC
CCCCTTACGAT -> CCCTTACGATC
CCCGAAGAACC -> CCGAAGAACCT
CCCGACAGTCG -> CCGACAGTCGT
CCCGCGTTAAC -> CCGCGTTAACT
CCCGGTTCGTT -> CCGGTTCGTTG
CCCGTTCATTG -> CCGTTCATTGA
CCCTCAGTCTC -> CCTCAGTCTCT
CCCTCCAGAGG -> CCTCCAGAGGA
CCCTCGTGGTC -> CCTCGTGGTCG
CCCTTACGATC -> CCTTACGATCA
CCCTTGAAAAT -> CCTTGAAAATT
CCGAAAAGTCC -> CGAAAAGTCCA
CCGAAGAACCT -> CGAAGAACCTA
CCGACAGTCGT -> CGACAGTCGTT
CCGACTCGTGC -> CGACTCGTGCG
CCGAGCAAAAC -> CGAGCAAAACA
CCGATCCGATT -> CGATCCGATTG
CCGATTAGCAC -> CGATTAGCACG
CCGATTGTTAA -> CGATTGTTAAA
CCGCACGACCG -> CGCACGACCGT
CCGCACTAGAT -> CGCACTAGATG
CCGCGTTAACT -> CGCGTTAACTC
CCGCTATTGCA -> CGCTATTGCAG
CCGCTTAACCT -> CGCTTAACCTC
CCGCTTTTAGC -> CGCTTTTAGCC
CCGGGGGCGTC -> CGGGGGCGTCA
CCGGTAAGTTG -> CGGTAAGTTGC
CCGGTGCCTGA -> CGGTGCCTGAT
CCGGTTCGTTG -> CGGTTCGTTGA
CCGTCTTGAGC -> CGTCTTGAGCC
CCGTGACTGGC -> CGTGACTGGCG
CCGTTCATTGA -> CGTTCATTGAG
CCGTTTTACGC -> CGTTTTACGCG
CCGTTTTTAGT -> CGTTTTTAGTA
CCTAACACGTT -> CTAACACGTTA
CCTATGCAACG -> CTATGCAACGG
CCTCAGTCTCT -> CTCAGTCTCTC
CCTCCAGAGGA -> CTCCAGAGGAC
CCTCGATATTA -> CTCGATATTAT
CCTCGTGGTCG -> CTCGTGGTCGT
CCTCTACGAGA -> CTCTACGAGAC
CCTCTTGAACC -> CTCTTGAACCG
CCTCTTTACCC -> CTCTTTACCCC
CCTGACGCATT -> CTGACGCATTC
CCTGATGAGTT -> CTGATGAGTTA
CCTGCGTGGTG -> CTGCGTGGTGC
CCTGGGATCCA -> CTGGGATCCAC
CCTGGGGATCA -> CTGGGGATCAG
CCTGTGATTTG -> CTGTGATTTGT
CCTTACGATCA -> CTTACGATCAC
CCTTAGGAGAA -> CTTAGGAGAAA
CCTTAGTCGAA -> CTTAGTCGAAC
CCTTCAAATGA -> CTTCAAATGAA
CCTTCGGTTGA -> CTTCGGTTGAT
CCTTCTGGCCC -> CTTCTGGCCCC
CCTTGAAAATT -> CTTGAAAATTG
CCTTGAATGAT -> CTTGAATGATG
CCTTTCAACGC -> CTTTCAACGCG
CCTTTCATTCA -> CTTTCATTCAA
CCTTTCTCCGC -> CTTTCTCCGCT
CGAAAACTGGT -> GAAAACTGGTG
CGAAAAGGGGC -> GAAAAGGGGCA
CGAAAAGTCCA -> GAAAAGTCCAT
CGAAAAGTTGC -> GAAAAGTTGCG
CGAACCTTAGG -> GAACCTTAGGA
CGAAGAACCTA -> GAAGAACCTAA
CGAATACTCTT -> GAATACTCTTT
CGAATTACGAC -> GAATTACGACT
CGACAACTATT -> GACAACTATTA
CGACAGTCGTT -> GACAGTCGTTA
CGACCGTTTTA -> GACCGTTTTAC
CGACGCCAAGC -> GACGCCAAGCT
CGACTACCTTG -> GACTACCTTGA
CGACTACGTGA -> GACTACGTGAG
CGACTATCATA -> GACTATCATAA
CGACTCGTGCG -> GACTCGTGCGT
CGACTGTTAAA -> GACTGTTAAAC
CGACTTATCGC -> GACTTATCGCG
CGAGACTAAAC -> GAGACTAAACT
CGAGCAAAACA -> GAGCAAAACAC
CGAGCTTTGGC -> GAGCTTTGGCA
CGAGGATCGTG -> GAGGATCGTGC
CGAGGCGTGAC -> GAGGCGTGACG
CGAGGGTGTAG -> GAGGGTGTAGA
CGATATTATCT -> GATATTATCTA
CGATCACCTGG -> GATCACCTGGG
CGATCCGATTG -> GATCCGATTGT
CGATCGCGTGG -> GATCGCGTGGG
CGATGCCGTCT -> GATGCCGTCTT
CGATTAGCACG -> GATTAGCACGC
CGATTGTTAAA -> GATTGTTAAAT
CGCAAGTGCAT -> GCAAGTGCATC
CGCACGACCGT -> GCACGACCGTT
CGCACTAGATG -> GCACTAGATGA
CGCATCTCCAC -> GCATCTCCACT
CGCATGACGCT -> GCATGACGCTT
CGCATGTAGGA -> GCATGTAGGAC
CGCATTCAGTA -> GCATTCAGTAC
CGCCAAGCTAA -> GCCAAGCTAAA
CGCCCTCCAGA -> GCCCTCCAGAG
CGCCTGTGATT -> GCCTGTGATTT
CGCCTTTCTCC -> GCCTTTCTCCG
CGCGACTACCT -> GCGACTACCTT
CGCGATCGCGT -> GCGATCGCGTG
CGCGCCCTCCA -> GCGCCCTCCAG
CGCGGAGCAAG -> GCGGAGCAAGC
CGCGGGGGATT -> GCGGGGGATTG
CGCGTCAGGGT -> GCGTCAGGGTG
CGCGTGAATTA -> GCGTGAATTAT
CGCGTGGGTAA -> GCGTGGGTAAG
CGCGTTAACTC -> GCGTTAACTCT
CGCTAACCTCG -> GCTAACCTCGA
CGCTATGTCAG -> GCTATGTCAGT
CGCTATTGCAG -> GCTATTGCAGT
CGCTCGAGCTT -> GCTCGAGCTTT
CGCTGGTCGAA -> GCTGGTCGAAA
CGCTTAACCTC -> GCTTAACCTCT
CGCTTACAAGT -> GCTTACAAGTG
CGCTTAGCTGG -> GCTTAGCTGGG
CGCTTCAGGAT -> GCTTCAGGATC
CGCTTTTAGCC -> GCTTTTAGCCT
CGGACATCCTT -> GGACATCCTTT
CGGAGATTTCA -> GGAGATTTCAC
CGGAGCAAGCG -> GGAGCAAGCGG
CGGAGTGCCTT -> GGAGTGCCTTC
CGGATTTAAGC -> GGATTTAAGCA
CGGATTTGCCG -> GGATTTGCCGA
CGGATTTTTCG -> GGATTTTTCGA
CGGCAGTACCA -> GGCAGTACCAC
CGGCATCCTAT -> GGCATCCTATG
CGGCATGCGTC -> GGCATGCGTCG
CGGCGTCACAG -> GGCGTCACAGT
CGGCGTCCAAG -> GGCGTCCAAGT
CGGGGGATTGG -> GGGGGATTGGC
CGGGGGCGTCA -> GGGGGCGTCAA
CGGGTAAATGT -> GGGTAAATGTC
CGGTAAGTTGC -> GGTAAGTTGCT
CGGTACCCAGC -> GGTACCCAGCA
CGGTCTCTATT -> GGTCTCTATTG
CGGTGCCTGAT -> GGTGCCTGATG
CGGTGCTAGTA -> GGTGCTAGTAC
CGGTGGAAGTG -> GGTGGAAGTGT
CGGTGTGTTTT -> GGTGTGTTTTG
CGGTTCGTTGA -> GGTTCGTTGAT
CGGTTGATGGG -> GGTTGATGGGA
CGTAACTCGGC -> GTAACTCGGCA
CGTACCGACTC -> GTACCGACTCG
CGTAGAATGCA -> GTAGAATGCAG
CGTATTGCTAC -> GTATTGCTACG
CGTCAATCCAT -> GTCAATCCATG
CGTCACAGTGT -> GTCACAGTGTC
CGTCACTTTAC -> GTCACTTTACA
CGTCAGGGTGT -> GTCAGGGTGTA
CGTCCAAGTAC -> GTCCAAGTACG
CGTCCGTGACT -> GTCCGTGACTG
CGTCCTGACGC -> GTCCTGACGCA
CGTCGGAGATT -> GTCGGAGATTT
CGTCGTCCGTG -> GTCGTCCGTGA
CGTCTCATAGT -> GTCTCATAGTA
CGTCTTGAGCC -> GTCTTGAGCCG
CGTGAATCGAC -> GTGAATCGACT
CGTGAATTATT -> GTGAATTATTA
CGTGACAGTGG -> GTGACAGTGGA
CGTGACGGTCT -> GTGACGGTCTC
CGTGACTGGCG -> GTGACTGGCGA
CGTGAGCACCT -> GTGAGCACCTT
CGTGCACCTGG -> GTGCACCTGGG
CGTGCGCCTGT -> GTGCGCCTGTG
CGTGCGTCCTG -> GTGCGTCCTGA
CGTGGGTAAGT -> GTGGGTAAGTA
CGTGGTCGTCA -> GTGGTCGTCAC
CGTGGTGCCAA -> GTGGTGCCAAA
CGTTAAACCCA -> GTTAAACCCAT
CGTTAACTCTT -> GTTAACTCTTA
CGTTAGTAGCG -> GTTAGTAGCGC
CGTTCATTGAG -> GTTCATTGAGT
CGTTGATCTAG -> GTTGATCTAGC
CGTTTTACGCG -> GTTTTACGCGC
CGTTTTTAGTA -> GTTTTTAGTAT
CTAAACTCATA -> TAAACTCATAG
CTAAACTTTCT -> TAAACTTTCTG
CTAACACGTTA -> TAACACGTTAA
CTAACCTCGAT -> TAACCTCGATA
CTAATAAACCA -> TAATAAACCAA
CTACACAGTCC -> TACACAGTCCT
CTACAGTGGCA -> TACAGTGGCAG
CTACATATCAG -> TACATATCAGC
CTACCCTCGTG -> TACCCTCGTGG
CTACCCTTGAA -> TACCCTTGAAA
CTACCTTGAAT -> TACCTTGAATG
CTACGAGACTA -> TACGAGACTAA
CTACGGACATC -> TACGGACATCC
CTACGGCGTCC -> TACGGCGTCCA
CTACGTAGAAT -> TACGTAGAATG
CTACGTGAGCA -> TACGTGAGCAC
CTAGAGCTCGT -> TAGAGCTCGTA
CTAGATGATTC -> TAGATGATTCA
CTAGCCACTCC -> TAGCCACTCCA
CTAGCGCTAAC -> TAGCGCTAACC
CTAGGACTGTT -> TAGGACTGTTG
CTAGTACTAGG -> TAGTACTAGGA
CTATCACGAGG -> TATCACGAGGA
CTATCATAATC -> TATCATAATCC
CTATCGGTGGA -> TATCGGTGGAA
CTATGCAACGG -> TATGCAACGGC
CTATGCTATCG -> TATGCTATCGG
CTATGTCAGTT -> TATGTCAGTTG
CTATTACGGAT -> TATTACGGATT
CTATTGAGAGG -> TATTGAGAGGC
CTATTGCAGTG -> TATTGCAGTGA
CTCACTACGGC -> TCACTACGGCG
CTCAGAGTTTA -> TCAGAGTTTAA
CTCAGCACATC -> TCAGCACATCG
CTCAGTCTCTC -> TCAGTCTCTCG
CTCATAGGGAC -> TCATAGGGACT
CTCATAGTAAG -> TCATAGTAAGG
CTCATTTGCAT -> TCATTTGCATC
CTCCACTAGCG -> TCCACTAGCGC
CTCCAGAGCTT -> TCCAGAGCTTT
CTCCAGAGGAC -> TCCAGAGGACG
CTCCAGATTTT -> TCCAGATTTTT
CTCCAGCGCAT -> TCCAGCGCATG
CTCCGCTATTG -> TCCGCTATTGC
CTCCGTTTTTA -> TCCGTTTTTAG
CTCGAGCTTTG -> TCGAGCTTTGG
CTCGAGGGTGT -> TCGAGGGTGTA
CTCGATATTAT -> TCGATATTATC
CTCGCTCGAGC -> TCGCTCGAGCT
CTCGGCAGTAC -> TCGGCAGTACC
CTCGTACCGAC -> TCGTACCGACT
CTCGTCTCATA -> TCGTCTCATAG
CTCGTGACAGT -> TCGTGACAGTG
CTCGTGCGCCT -> TCGTGCGCCTG
CTCGTGCGTCC -> TCGTGCGTCCT
CTCGTGGTCGT -> TCGTGGTCGTC
CTCTACGAGAC -> TCTACGAGACT
CTCTAGAGCTC -> TCTAGAGCTCG
CTCTATTGAGA -> TCTATTGAGAG
CTCTCGAGGGT -> TCTCGAGGGTG
CTCTCGCTCGA -> TCTCGCTCGAG
CTCTCGTGACA -> TCTCGTGACAG
CTCTGGTGTGA -> TCTGGTGTGAG
CTCTTACATCC -> TCTTACATCCC
CTCTTGAACCG -> TCTTGAACCGA
CTCTTTACCCC -> TCTTTACCCCT
CTCTTTAGCCA -> TCTTTAGCCAT
CTGAATCAAGC -> TGAATCAAGCG
CTGACGCATTC -> TGACGCATTCA
CTGAGAGCAAA -> TGAGAGCAAAT
CTGATGAGTTA -> TGATGAGTTAT
CTGCCATGCAA -> TGCCATGCAAC
CTGCCGATTAG -> TGCCGATTAGC
CTGCGTGGTGC -> TGCGTGGTGCC
CTGCTACAGTG -> TGCTACAGTGG
CTGGAGATTCT -> TGGAGATTCTC
CTGGCCCCGGT -> TGGCCCCGGTT
CTGGCGAGGCG -> TGGCGAGGCGT
CTGGGATCCAC -> TGGGATCCACT
CTGGGGATCAG -> TGGGGATCAGA
CTGGGTCCGGT -> TGGGTCCGGTG
CTGGTCGAAAA -> TGGTCGAAAAG
CTGGTGACCAG -> TGGTGACCAGA
CTGGTGTGAGT -> TGGTGTGAGTG
CTGTAGATCAA -> TGTAGATCAAT
CTGTCGCGGGG -> TGTCGCGGGGG
CTGTGATTTGT -> TGTGATTTGTT
CTGTTAAACAA -> TGTTAAACAAA
CTGTTGCGGGT -> TGTTGCGGGTA
CTGTTGTAGGG -> TGTTGTAGGGG
CTTAACCTCTT -> TTAACCTCTTT
CTTAAGCTCTC -> TTAAGCTCTCG
CTTACAAGTGC -> TTACAAGTGCG
CTTACATCCCA -> TTACATCCCAT
CTTACGATCAC -> TTACGATCACC
CTTAGCTGGGT -> TTAGCTGGGTC
CTTAGGAGAAA -> TTAGGAGAAAC
CTTAGTCGAAC -> TTAGTCGAACC
CTTATAGCTGG -> TTATAGCTGGA
CTTATATTATT -> TTATATTATTA
CTTATCGCGTG -> TTATCGCGTGA
CTTCAAATGAA -> TTCAAATGAAC
CTTCAGGATCA -> TTCAGGATCAA
CTTCGGTTGAT -> TTCGGTTGATG
CTTCTGGCCCC -> TTCTGGCCCCG
CTTGAAAATTG -> TTGAAAATTGA
CTTGAACCGAA -> TTGAACCGAAA
CTTGAATGATG -> TTGAATGATGT
CTTGAGCCGAT -> TTGAGCCGATC
CTTGATGGATT -> TTGATGGATTT
CTTGTTCGACT -> TTGTTCGACTT
CTTTACATTTT -> TTTACATTTTG
CTTTACCCCTT -> TTTACCCCTTA
CTTTAGCAAAT -> TTTAGCAAATT
CTTTAGCCATG -> TTTAGCCATGC
CTTTCAACGCG -> TTTCAACGCGT
CTTTCATTCAA -> TTTCATTCAAA
CTTTCCGCTTT -> TTTCCGCTTTT
CTTTCTCCGCT -> TTTCTCCGCTA
CTTTCTGTTGT -> TTTCTGTTGTA
CTTTGGCACGT -> TTTGGCACGTA
CTTTTAGCCTG -> TTTTAGCCTGC
CTTTTTTTGTA -> TTTTTTTGTAT
GAAAACTGGTG -> AAAACTGGTGA
GAAAAGGGGCA -> AAAAGGGGCAA
GAAAAGTCCAT -> AAAAGTCCATC
GAAAAGTTGCG -> AAAAGTTGCGT
GAAAATTGACC -> AAAATTGACCC
GAAACACACTG -> AAACACACTGA
GAAAGGGATTA -> AAAGGGATTAT
GAAATGCAATC -> AAATGCAATCG
GAACAGTAGAA -> AACAGTAGAAT
GAACCGAAAAG -> AACCGAAAAGT
GAACCGGTAAG -> AACCGGTAAGT
GAACCTAACAC -> AACCTAACACG
GAACCTTAGGA -> AACCTTAGGAG
GAACTGCCATG -> AACTGCCATGC
GAAGAACCTAA -> AAGAACCTAAC
GAAGATCTACG -> AAGATCTACGT
GAAGTGTCACT -> AAGTGTCACTC
GAATACAATAT -> AATACAATATA
GAATACTCTTT -> AATACTCTTTA
GAATCAAGCGA -> AATCAAGCGAA
GAATCGACTGT -> AATCGACTGTT
GAATCTATCAC -> AATCTATCACG
GAATGATGTAC -> AATGATGTACG
GAATGCAGATC -> AATGCAGATCC
GAATTACGACT -> AATTACGACTA
GAATTATTACC -> AATTATTACCG
GAATTCAATTA -> AATTCAATTAC
GACAACTATTA -> ACAACTATTAC
GACACTACATA -> ACACTACATAT
GACAGTCGTTA -> ACAGTCGTTAG
GACAGTGACCA -> ACAGTGACCAC
GACAGTGGAGC -> ACAGTGGAGCA
GACATCCTTTC -> ACATCCTTTCA
GACATCGCATG -> ACATCGCATGA
GACCACTGTCG -> ACCACTGTCGC
GACCAGATCAT -> ACCAGATCATT
GACCCATGTCC -> ACCCATGTCCT
GACCCCGCGTT -> ACCCCGCGTTA
GACCGCACTAG -> ACCGCACTAGA
GACCGTTTTAC -> ACCGTTTTACG
GACGCATCTCC -> ACGCATCTCCA
GACGCATTCAG -> ACGCATTCAGT
GACGCCAAGCT -> ACGCCAAGCTA
GACGCTATGTC -> ACGCTATGTCA
GACGCTTAGCT -> ACGCTTAGCTG
GACGGATTTAA -> ACGGATTTAAG
GACGGTCTCTA -> ACGGTCTCTAT
GACTAAACTCA -> ACTAAACTCAT
GACTACCCTCG -> ACTACCCTCGT
GACTACCTTGA -> ACTACCTTGAA
GACTACGTGAG -> ACTACGTGAGC
GACTATCATAA -> ACTATCATAAT
GACTCGTGCGT -> ACTCGTGCGTC
GACTGGCGAGG -> ACTGGCGAGGC
GACTGTTAAAC -> ACTGTTAAACA
GACTGTTGCGG -> ACTGTTGCGGG
GACTTATCGCG -> ACTTATCGCGT
GACTTTTTTTG -> ACTTTTTTTGT
GAGAAACACAC -> AGAAACACACT
GAGAAGATCTA -> AGAAGATCTAC
GAGACTAAACT -> AGACTAAACTC
GAGAGCAAATT -> AGAGCAAATTT
GAGAGGATTGC -> AGAGGATTGCA
GAGAGGCTGTA -> AGAGGCTGTAG
GAGATTAGGCG -> AGATTAGGCGG
GAGATTCTCTA -> AGATTCTCTAG
GAGATTTCACA -> AGATTTCACAG
GAGCAAAACAC -> AGCAAAACACG
GAGCAAATTTT -> AGCAAATTTTT
GAGCAACTCCA -> AGCAACTCCAG
GAGCAAGCGGA -> AGCAAGCGGAT
GAGCACCTTCG -> AGCACCTTCGG
GAGCCGATCCG -> AGCCGATCCGA
GAGCTCGTACC -> AGCTCGTACCG
GAGCTGCTACA -> AGCTGCTACAG
GAGCTTTCCGC -> AGCTTTCCGCT
GAGCTTTGGCA -> AGCTTTGGCAC
GAGGACGCATC -> AGGACGCATCT
GAGGATCGTGC -> AGGATCGTGCA
GAGGATTGCAC -> AGGATTGCACT
GAGGCATTATG -> AGGCATTATGT
GAGGCGTGACG -> AGGCGTGACGG
GAGGCTCGTCT -> AGGCTCGTCTC
GAGGCTGTAGA -> AGGCTGTAGAT
GAGGGTGTAGA -> AGGGTGTAGAA
GAGTGAGAAGA -> AGTGAGAAGAT
GAGTGCCTTCA -> AGTGCCTTCAA
GAGTTATGAAC -> AGTTATGAACC,AGTTATGAACT
GAGTTTAATAA -> AGTTTAATAAG
GATATTATCTA -> ATATTATCTAC
GATCAAAGACA -> ATCAAAGACAG
GATCAATAAGC -> ATCAATAAGCA
GATCACCTGGG -> ATCACCTGGGG
GATCAGAATCT -> ATCAGAATCTA
GATCATTTGAT -> ATCATTTGATC
GATCCACACTG -> ATCCACACTGC
GATCCACTCTC -> ATCCACTCTCG
GATCCGATTGT -> ATCCGATTGTT
GATCGCGTGGG -> ATCGCGTGGGT
GATCGTGCACC -> ATCGTGCACCT
GATCTACGTAG -> ATCTACGTAGA
GATCTAGCCAC -> ATCTAGCCACT
GATCTCCGTTT -> ATCTCCGTTTT
GATGAGTTATG -> ATGAGTTATGA
GATGATTCACA -> ATGATTCACAA
GATGCCGTCTT -> ATGCCGTCTTG
GATGGATTTGA -> ATGGATTTGAT
GATGGGAATAC -> ATGGGAATACA
GATGTACGTGA -> ATGTACGTGAA
GATTAAACATA -> ATTAAACATAC
GATTAGCACGC -> ATTAGCACGCC
GATTAGGCGGT -> ATTAGGCGGTA
GATTATTAAAA -> ATTATTAAAAT
GATTCACAACC -> ATTCACAACCC
GATTCTCTAGA -> ATTCTCTAGAG
GATTGCACTTT -> ATTGCACTTTA
GATTGGCGGTG -> ATTGGCGGTGC
GATTGGGCGGA -> ATTGGGCGGAG
GATTGTTAAAT -> ATTGTTAAATG
GATTTAAGCAT -> ATTTAAGCATC
GATTTCACAGT -> ATTTCACAGTA
GATTTGATTGG -> ATTTGATTGGG
GATTTGCCGAG -> ATTTGCCGAGC
GATTTGTTCTA -> ATTTGTTCTAA
GATTTTTCGAA -> ATTTTTCGAAA
GATTTTTCGAC -> ATTTTTCGACG
GCAAAACACGG -> CAAAACACGGC
GCAAATTGCTT -> CAAATTGCTTA
GCAAATTTTTA -> CAAATTTTTAT
GCAACATTGAC -> CAACATTGACG
GCAACGGCGTC -> CAACGGCGTCA
GCAACTCCAGA -> CAACTCCAGAG
GCAAGCGCGAT -> CAAGCGCGATC
GCAAGCGGATT -> CAAGCGGATTT
GCAAGTGCATC -> CAAGTGCATCT
GCAAGTGTAAG -> CAAGTGTAAGA
GCAATCGCTTC -> CAATCGCTTCA
GCACATCGAAA -> CACATCGAAAA
GCACCCCTCAG -> CACCCCTCAGT
GCACCTGGGAT -> CACCTGGGATC
GCACCTTCGGT -> CACCTTCGGTT
GCACGACCGTT -> CACGACCGTTT
GCACGCCTTTC -> CACGCCTTTCT
GCACGGTGTGT -> CACGGTGTGTT
GCACGTATTGC -> CACGTATTGCT
GCACTAGATGA -> CACTAGATGAT
GCACTTTAGCA -> CACTTTAGCAA
GCAGAGGCATT -> CAGAGGCATTA
GCAGATCCACA -> CAGATCCACAC
GCAGGTTTCCA -> CAGGTTTCCAG
GCAGTACCACA -> CAGTACCACAC
GCAGTGATTAA -> CAGTGATTAAA
GCAGTTAGACA -> CAGTTAGACAT
GCATCCTATGC -> CATCCTATGCA
GCATCGATGCC -> CATCGATGCCG
GCATCTATGCT -> CATCTATGCTA
GCATCTCCACT -> CATCTCCACTA
GCATCTCCAGC -> CATCTCCAGCG
GCATGACGCTT -> CATGACGCTTA
GCATGACTTTT -> CATGACTTTTT
GCATGCGTCGT -> CATGCGTCGTC
GCATGTAGGAC -> CATGTAGGACC
GCATTATGTGT -> CATTATGTGTC
GCATTCAGTAC -> CATTCAGTACA
GCCAAAAGTCC -> CCAAAAGTCCT
GCCAAGCTAAA -> CCAAGCTAAAC
GCCACTCCAGA -> CCACTCCAGAT
GCCATGCAACG -> CCATGCAACGG
GCCATGCACCC -> CCATGCACCCC
GCCCCGGTTCG -> CCCCGGTTCGT
GCCCGTTCATT -> CCCGTTCATTG
GCCCTCCAGAG -> CCCTCCAGAGG
GCCGAGCAAAA -> CCGAGCAAAAC
GCCGATCCGAT -> CCGATCCGATT
GCCGATTAGCA -> CCGATTAGCAC
GCCGCTTAACC -> CCGCTTAACCT
GCCGGGGGCGT -> CCGGGGGCGTC
GCCGTCTTGAG -> CCGTCTTGAGC
GCCTCTACGAG -> CCTCTACGAGA
GCCTGATGAGT -> CCTGATGAGTT
GCCTGCGTGGT -> CCTGCGTGGTG
GCCTGTGATTT -> CCTGTGATTTG
GCCTTCAAATG -> CCTTCAAATGA
GCCTTCTGGCC -> CCTTCTGGCCC
GCCTTTCTCCG -> CCTTTCTCCGC
GCGAATACTCT -> CGAATACTCTT
GCGACAACTAT -> CGACAACTATT
GCGACTACCTT -> CGACTACCTTG
GCGACTATCAT -> CGACTATCATA
GCGAGGCGTGA -> CGAGGCGTGAC
GCGATCGCGTG -> CGATCGCGTGG
GCGCAAGTGCA -> CGCAAGTGCAT
GCGCATGTAGG -> CGCATGTAGGA
GCGCCCTCCAG -> CGCCCTCCAGA
GCGCCTGTGAT -> CGCCTGTGATT
GCGCGATCGCG -> CGCGATCGCGT
GCGCTAACCTC -> CGCTAACCTCG
GCGCTGGTCGA -> CGCTGGTCGAA
GCGGAGCAAGC -> CGGAGCAAGCG
GCGGAGTGCCT -> CGGAGTGCCTT
GCGGATTTTTC -> CGGATTTTTCG
GCGGGGGATTG -> CGGGGGATTGG
GCGGGTAAATG -> CGGGTAAATGT
GCGGTACCCAG -> CGGTACCCAGC
GCGGTGCTAGT -> CGGTGCTAGTA
GCGTAACTCGG -> CGTAACTCGGC
GCGTCAATCCA -> CGTCAATCCAT
GCGTCACAGTG -> CGTCACAGTGT
GCGTCAGGGTG -> CGTCAGGGTGT
GCGTCCAAGTA -> CGTCCAAGTAC
GCGTCCTGACG -> CGTCCTGACGC
GCGTCGTCCGT -> CGTCGTCCGTG
GCGTGAATTAT -> CGTGAATTATT
GCGTGACGGTC -> CGTGACGGTCT
GCGTGGGTAAG -> CGTGGGTAAGT
GCGTGGTGCCA -> CGTGGTGCCAA
GCGTTAACTCT -> CGTTAACTCTT
GCTAAACTTTC -> CTAAACTTTCT
GCTAACCTCGA -> CTAACCTCGAT
GCTACACAGTC -> CTACACAGTCC
GCTACAGTGGC -> CTACAGTGGCA
GCTACGGACAT -> CTACGGACATC
GCTAGTACTAG -> CTAGTACTAGG
GCTATCGGTGG -> CTATCGGTGGA
GCTATGTCAGT -> CTATGTCAGTT
GCTATTGCAGT -> CTATTGCAGTG
GCTCATTTGCA -> CTCATTTGCAT
GCTCGAGCTTT -> CTCGAGCTTTG
GCTCGTACCGA -> CTCGTACCGAC
GCTCGTCTCAT -> CTCGTCTCATA
GCTCTCGTGAC -> CTCTCGTGACA
GCTGCTACAGT -> CTGCTACAGTG
GCTGGAGATTC -> CTGGAGATTCT
GCTGGGTCCGG -> CTGGGTCCGGT
GCTGGTCGAAA -> CTGGTCGAAAA
GCTGTAGATCA -> CTGTAGATCAA
GCTTAACCTCT -> CTTAACCTCTT
GCTTAAGCTCT -> CTTAAGCTCTC
GCTTACAAGTG -> CTTACAAGTGC
GCTTAGCTGGG -> CTTAGCTGGGT
GCTTATATTAT -> CTTATATTATT
GCTTCAGGATC -> CTTCAGGATCA
GCTTTCCGCTT -> CTTTCCGCTTT
GCTTTGGCACG -> CTTTGGCACGT
GCTTTTAGCCT -> CTTTTAGCCTG
GGAAGTGTCAC -> GAAGTGTCACT
GGAATACAATA -> GAATACAATAT
GGACATCCTTT -> GACATCCTTTC
GGACCGCACTA -> GACCGCACTAG
GGACGCATCTC -> GACGCATCTCC
GGACTACCCTC -> GACTACCCTCG
GGACTGTTGCG -> GACTGTTGCGG
GGAGAAACACA -> GAGAAACACAC
GGAGAGGATTG -> GAGAGGATTGC
GGAGATTCTCT -> GAGATTCTCTA
GGAGATTTCAC -> GAGATTTCACA
GGAGCAACTCC -> GAGCAACTCCA
GGAGCAAGCGG -> GAGCAAGCGGA
GGAGCTGCTAC -> GAGCTGCTACA
GGAGTGCCTTC -> GAGTGCCTTCA
GGATCAAAGAC -> GATCAAAGACA
GGATCAGAATC -> GATCAGAATCT
GGATCCACTCT -> GATCCACTCTC
GGATCGTGCAC -> GATCGTGCACC
GGATTATTAAA -> GATTATTAAAA
GGATTGCACTT -> GATTGCACTTT
GGATTGGCGGT -> GATTGGCGGTG
GGATTTAAGCA -> GATTTAAGCAT
GGATTTGATTG -> GATTTGATTGG
GGATTTGCCGA -> GATTTGCCGAG
GGATTTTTCGA -> GATTTTTCGAA
GGCAACATTGA -> GCAACATTGAC
GGCACGTATTG -> GCACGTATTGC
GGCAGAGGCAT -> GCAGAGGCATT
GGCAGTACCAC -> GCAGTACCACA
GGCAGTTAGAC -> GCAGTTAGACA
GGCATCCTATG -> GCATCCTATGC
GGCATGCGTCG -> GCATGCGTCGT
GGCATTATGTG -> GCATTATGTGT
GGCCCCGGTTC -> GCCCCGGTTCG
GGCCCGTTCAT -> GCCCGTTCATT
GGCCGCTTAAC -> GCCGCTTAACC
GGCCGGGGGCG -> GCCGGGGGCGT
GGCCTCTACGA -> GCCTCTACGAG
GGCGAGGCGTG -> GCGAGGCGTGA
GGCGCTGGTCG -> GCGCTGGTCGA
GGCGGAGTGCC -> GCGGAGTGCCT
GGCGGTACCCA -> GCGGTACCCAG
GGCGGTGCTAG -> GCGGTGCTAGT
GGCGTCAATCC -> GCGTCAATCCA
GGCGTCACAGT -> GCGTCACAGTG
GGCGTCCAAGT -> GCGTCCAAGTA
GGCGTGACGGT -> GCGTGACGGTC
GGCTCGTCTCA -> GCTCGTCTCAT
GGCTGTAGATC -> GCTGTAGATCA
GGGAATACAAT -> GGAATACAATA
GGGACTACCCT -> GGACTACCCTC
GGGATCAGAAT -> GGATCAGAATC
GGGATCCACTC -> GGATCCACTCT
GGGATTATTAA -> GGATTATTAAA
GGGATTGGCGG -> GGATTGGCGGT
GGGCAACATTG -> GGCAACATTGA
GGGCCCGTTCA -> GGCCCGTTCAT
GGGCCGCTTAA -> GGCCGCTTAAC
GGGCCTCTACG -> GGCCTCTACGA
GGGCGGAGTGC -> GGCGGAGTGCC
GGGCGTCAATC -> GGCGTCAATCC
GGGGATCAGAA -> GGGATCAGAAT
GGGGATTGGCG -> GGGATTGGCGG
GGGGCAACATT -> GGGCAACATTG
GGGGCCGCTTA -> GGGCCGCTTAA
GGGGCGTCAAT -> GGGCGTCAATC
GGGGGATTGGC -> GGGGATTGGCG
GGGGGCGTCAA -> GGGGCGTCAAT
GGGTAAATGTC -> GGTAAATGTCA
GGGTAAGTATG -> GGTAAGTATGC
GGGTCCGGTGC -> GGTCCGGTGCC
GGGTGTAGAAA -> GGTGTAGAAAG
GGGTGTATCCA -> GGTGTATCCAC
GGTAAATGTCA -> GTAAATGTCAA
GGTAAGTATGC -> GTAAGTATGCA
GGTAAGTTGCT -> GTAAGTTGCTA
GGTACACGAAT -> GTACACGAATT
GGTACCCAGCA -> GTACCCAGCAG
GGTCCGGTGCC -> GTCCGGTGCCT
GGTCGAAAAGT -> GTCGAAAAGTT
GGTCGTCACTT -> GTCGTCACTTT
GGTCTCTATTG -> GTCTCTATTGA
GGTGACCAGAT -> GTGACCAGATC
GGTGAGGCTCG -> GTGAGGCTCGT
GGTGCCAAAAG -> GTGCCAAAAGT
GGTGCCTGATG -> GTGCCTGATGA
GGTGCTAGTAC -> GTGCTAGTACT
GGTGGAAGTGT -> GTGGAAGTGTC
GGTGTAGAAAG -> GTGTAGAAAGG
GGTGTATCCAC -> GTGTATCCACA
GGTGTGAGTGA -> GTGTGAGTGAG
GGTGTGTTTTG -> GTGTGTTTTGG
GGTTATCTTAT -> GTTATCTTATA
GGTTCGTTGAT -> GTTCGTTGATC
GGTTCTGAATC -> GTTCTGAATCA
GGTTGATGGGA -> GTTGATGGGAA
GGTTGGTGAGG -> GTTGGTGAGGC
GGTTTCCAGTG -> GTTTCCAGTGG
GTAAATGTCAA -> TAAATGTCAAT
GTAACTCGGCA -> TAACTCGGCAG
GTAAGAGATTA -> TAAGAGATTAG
GTAAGGTACAC -> TAAGGTACACG
GTAAGTATGCA -> TAAGTATGCAC
GTAAGTTGCTA -> TAAGTTGCTAC
GTACAAGACAC -> TACAAGACACT
GTACACGAATT -> TACACGAATTA
GTACATATCTC -> TACATATCTCA
GTACCACACCA -> TACCACACCAA
GTACCCAGCAG -> TACCCAGCAGG
GTACCGACTCG -> TACCGACTCGT
GTACGCGACTA -> TACGCGACTAC
GTACGCTTACA -> TACGCTTACAA
GTACGTCGGAG -> TACGTCGGAGA
GTACGTGAATC -> TACGTGAATCG
GTACTAGGACT -> TACTAGGACTG
GTAGAAAGGGA -> TAGAAAGGGAT
GTAGAATGCAG -> TAGAATGCAGA
GTAGAATTCAA -> TAGAATTCAAT
GTAGATCAATA -> TAGATCAATAA
GTAGCGCAAGT -> TAGCGCAAGTG
GTAGGACCGCA -> TAGGACCGCAC
GTAGGGGCCGC -> TAGGGGCCGCT
GTAGGTTGGTG -> TAGGTTGGTGA
GTAGTACAAGA -> TAGTACAAGAC
GTATCCACAGT -> TATCCACAGTA
GTATGAAATGC -> TATGAAATGCA
GTATGACGCTA -> TATGACGCTAT
GTATGCACGGT -> TATGCACGGTG
GTATTGCTACG -> TATTGCTACGG
GTCAATCCATG -> TCAATCCATGT
GTCAATGGTTA -> TCAATGGTTAT
GTCACAGCATG -> TCACAGCATGA
GTCACAGTGTC -> TCACAGTGTCA
GTCACTCAGCA -> TCACTCAGCAC
GTCACTTTACA -> TCACTTTACAT
GTCAGGGTGTA -> TCAGGGTGTAT
GTCAGTTGGCC -> TCAGTTGGCCG
GTCCAAGTACG -> TCCAAGTACGT
GTCCATCTTGT -> TCCATCTTGTT
GTCCGGTGCCT -> TCCGGTGCCTG
GTCCGTGACTG -> TCCGTGACTGG
GTCCTCTTGAA -> TCCTCTTGAAC
GTCCTGACGCA -> TCCTGACGCAT
GTCCTTAGTCG -> TCCTTAGTCGA
GTCCTTTCAAC -> TCCTTTCAACG
GTCGAAAAGTT -> TCGAAAAGTTG
GTCGAACCTTA -> TCGAACCTTAG
GTCGCGGGGGA -> TCGCGGGGGAT
GTCGGAGATTT -> TCGGAGATTTC
GTCGTCACTTT -> TCGTCACTTTA
GTCGTCCGTGA -> TCGTCCGTGAC
GTCGTTAGTAG -> TCGTTAGTAGC
GTCTCATAGTA -> TCTCATAGTAA
GTCTCGTGCGC -> TCTCGTGCGCC
GTCTCTATTGA -> TCTCTATTGAG
GTCTCTCGCTC -> TCTCTCGCTCG
GTCTTGAGCCG -> TCTTGAGCCGA
GTCTTGATGGA -> TCTTGATGGAT
GTGAATCGACT -> TGAATCGACTG
GTGAATTATTA -> TGAATTATTAC
GTGACAGTGGA -> TGACAGTGGAG
GTGACCACTGT -> TGACCACTGTC
GTGACCAGATC -> TGACCAGATCA
GTGACGGTCTC -> TGACGGTCTCT
GTGACTGGCGA -> TGACTGGCGAG
GTGAGAAGATC -> TGAGAAGATCT
GTGAGCACCTT -> TGAGCACCTTC
GTGAGGCTCGT -> TGAGGCTCGTC
GTGAGTGAGAA -> TGAGTGAGAAG
GTGATTAAACA -> TGATTAAACAT
GTGATTTGTTC -> TGATTTGTTCT
GTGCACCTGGG -> TGCACCTGGGA
GTGCATCTATG -> TGCATCTATGC
GTGCCAAAAGT -> TGCCAAAAGTC
GTGCCTGATGA -> TGCCTGATGAG
GTGCCTTCAAA -> TGCCTTCAAAT
GTGCGACAACT -> TGCGACAACTA
GTGCGCCTGTG -> TGCGCCTGTGA
GTGCGTCCTGA -> TGCGTCCTGAC
GTGCTAGTACT -> TGCTAGTACTA
GTGGAAGTGTC -> TGGAAGTGTCA
GTGGAGCAACT -> TGGAGCAACTC
GTGGCAGAGGC -> TGGCAGAGGCA
GTGGCAGTTAG -> TGGCAGTTAGA
GTGGGTAAGTA -> TGGGTAAGTAT
GTGGTCGTCAC -> TGGTCGTCACT
GTGGTGCCAAA -> TGGTGCCAAAA
GTGTAAGAGAT -> TGTAAGAGATT
GTGTAGAAAGG -> TGTAGAAAGGG
GTGTATCCACA -> TGTATCCACAG
GTGTCACAGCA -> TGTCACAGCAT
GTGTCACTCAG -> TGTCACTCAGC
GTGTCTTGATG -> TGTCTTGATGG
GTGTGAGTGAG -> TGTGAGTGAGA
GTGTGTTTTGG -> TGTGTTTTGGC
GTGTTTTGGCG -> TGTTTTGGCGC
GTTAAACAAAG -> TTAAACAAAGG
GTTAAACCCAT -> TTAAACCCATT
GTTAAATGTAC -> TTAAATGTACG
GTTAACTCTTA -> TTAACTCTTAC
GTTAGACATCG -> TTAGACATCGC
GTTAGTAGCGC -> TTAGTAGCGCA
GTTATCTTATA -> TTATCTTATAG
GTTATGAACCG -> TTATGAACCGG
GTTATGAACTG -> TTATGAACTGC
GTTCATTGAGT -> TTCATTGAGTT
GTTCGACTTAT -> TTCGACTTATC
GTTCGTTGATC -> TTCGTTGATCT
GTTCTAATAAA -> TTCTAATAAAC
GTTCTGAATCA -> TTCTGAATCAA
GTTGATCTAGC -> TTGATCTAGCC
GTTGATGGGAA -> TTGATGGGAAT
GTTGCGGGTAA -> TTGCGGGTAAA
GTTGCGTAACT -> TTGCGTAACTC
GTTGCTACACA -> TTGCTACACAG
GTTGGCCGGGG -> TTGGCCGGGGG
GTTGGTGAGGC -> TTGGTGAGGCT
GTTGTAGGGGC -> TTGTAGGGGCC
GTTTAATAAGG -> TTTAATAAGGT
GTTTCCAGTGG -> TTTCCAGTGGC
GTTTTACGCGC -> TTTTACGCGCC
GTTTTCTCAGA -> TTTTCTCAGAG
GTTTTGGCGCT -> TTTTGGCGCTG
GTTTTTAGTAT -> TTTTTAGTATG
TAAAAACATCA -> AAAAACATCAT
TAAAATTTAGC -> AAAATTTAGCT
TAAACAAAGGA -> AAACAAAGGAG
TAAACATACGG -> AAACATACGGC
TAAACCAATGC -> AAACCAATGCC
TAAACCCATTT -> AAACCCATTTG
TAAACTCATAG -> AAACTCATAGG
TAAACTTTCTG -> AAACTTTCTGT
TAAAGCGACTA -> AAAGCGACTAT
TAAATGTACGC -> AAATGTACGCG
TAAATGTCAAT -> AAATGTCAATG
TAACACGTTAA -> AACACGTTAAA
TAACCTCGATA -> AACCTCGATAT
TAACCTCTTTA -> AACCTCTTTAC
TAACTCGGCAG -> AACTCGGCAGT
TAACTCTTACA -> AACTCTTACAT
TAAGAGATTAG -> AAGAGATTAGG
TAAGCAAGTGT -> AAGCAAGTGTA
TAAGCATCGAT -> AAGCATCGATG
TAAGCTCTCGT -> AAGCTCTCGTG
TAAGGTACACG -> AAGGTACACGA
TAAGGTTCTGA -> AAGGTTCTGAA
TAAGTATGCAC -> AAGTATGCACG
TAAGTTGCTAC -> AAGTTGCTACA
TAATAAACCAA -> AATAAACCAAT
TAATAAGGTTC -> AATAAGGTTCT
TAATCCCGACA -> AATCCCGACAG
TACAAGACACT -> ACAAGACACTA
TACAAGACCCC -> ACAAGACCCCG
TACAAGTGCGA -> ACAAGTGCGAC
TACAATATAGC -> ACAATATAGCA
TACACAGTCCT -> ACACAGTCCTC
TACACGAATTA -> ACACGAATTAC
TACAGTGGCAG -> ACAGTGGCAGT
TACATATCAGC -> ACATATCAGCT
TACATATCTCA -> ACATATCTCAC
TACATCCCATC -> ACATCCCATCA
TACATTTTGTC -> ACATTTTGTCT
TACCACACCAA -> ACCACACCAAC
TACCCAGCAGG -> ACCCAGCAGGT
TACCCCTTACG -> ACCCCTTACGA
TACCCTCGTGG -> ACCCTCGTGGT
TACCCTTGAAA -> ACCCTTGAAAA
TACCGACTCGT -> ACCGACTCGTG
TACCGCACGAC -> ACCGCACGACC
TACCTTGAATG -> ACCTTGAATGA
TACGACTACGT -> ACGACTACGTG
TACGAGACTAA -> ACGAGACTAAA
TACGATCACCT -> ACGATCACCTG
TACGCGACTAC -> ACGCGACTACC
TACGCGCCCTC -> ACGCGCCCTCC
TACGCTTACAA -> ACGCTTACAAG
TACGGACATCC -> ACGGACATCCT
TACGGATTTGC -> ACGGATTTGCC
TACGGCATGCG -> ACGGCATGCGT
TACGGCGTCCA -> ACGGCGTCCAA
TACGTAGAATG -> ACGTAGAATGC
TACGTCGGAGA -> ACGTCGGAGAT
TACGTGAATCG -> ACGTGAATCGA
TACGTGAGCAC -> ACGTGAGCACC
TACTAGGACTG -> ACTAGGACTGT
TACTCTTTAGC -> ACTCTTTAGCC
TAGAAAGGGAT -> AGAAAGGGATT
TAGAATGCAGA -> AGAATGCAGAT
TAGAATTCAAT -> AGAATTCAATT
TAGACATCGCA -> AGACATCGCAT
TAGAGCTCGTA -> AGAGCTCGTAC
TAGATCAATAA -> AGATCAATAAG
TAGATGATTCA -> AGATGATTCAC
TAGCAAATTGC -> AGCAAATTGCT
TAGCAAGCGCG -> AGCAAGCGCGA
TAGCACGCCTT -> AGCACGCCTTT
TAGCCACTCCA -> AGCCACTCCAG
TAGCCATGCAC -> AGCCATGCACC
TAGCCTGCGTG -> AGCCTGCGTGG
TAGCGCAAGTG -> AGCGCAAGTGC
TAGCGCTAACC -> AGCGCTAACCT
TAGCTGGAGAT -> AGCTGGAGATT
TAGCTGGGTCC -> AGCTGGGTCCG
TAGCTTATATT -> AGCTTATATTA
TAGGACCGCAC -> AGGACCGCACT
TAGGACTGTTG -> AGGACTGTTGC
TAGGAGAAACA -> AGGAGAAACAC
TAGGCGGTACC -> AGGCGGTACCC
TAGGGACTACC -> AGGGACTACCC
TAGGGGCCGCT -> AGGGGCCGCTT
TAGGTTGGTGA -> AGGTTGGTGAG
TAGTAAGGTAC -> AGTAAGGTACA
TAGTACAAGAC -> AGTACAAGACA
TAGTACTAGGA -> AGTACTAGGAC
TAGTAGCGCAA -> AGTAGCGCAAG
TAGTATGACGC -> AGTATGACGCT
TAGTCGAACCT -> AGTCGAACCTT
TATAGCAAGCG -> ATAGCAAGCGC
TATAGCTGGAG -> ATAGCTGGAGA
TATATGGAGCT -> ATATGGAGCTG
TATATTATTAA -> ATATTATTAAA
TATCACGAGGA -> ATCACGAGGAT
TATCAGCTCAT -> ATCAGCTCATT
TATCATAATCC -> ATCATAATCCC
TATCCACAGTA -> ATCCACAGTAG
TATCGCGTGAA -> ATCGCGTGAAT
TATCGGTGGAA -> ATCGGTGGAAG
TATCTACCCTT -> ATCTACCCTTG
TATCTCACTAC -> ATCTCACTACG
TATCTTATAGC -> ATCTTATAGCT
TATGAAATGCA -> ATGAAATGCAA
TATGAACCGGT -> ATGAACCGGTA
TATGAACTGCC -> ATGAACTGCCA
TATGACGCTAT -> ATGACGCTATG
TATGCAACGGC -> ATGCAACGGCG
TATGCACGGTG -> ATGCACGGTGT
TATGCTATCGG -> ATGCTATCGGT
TATGGAGCTGC -> ATGGAGCTGCT
TATGTCAGTTG -> ATGTCAGTTGG
TATGTGTCTTG -> ATGTGTCTTGA
TATTAAAAACA -> ATTAAAAACAT
TATTAAAATTT -> ATTAAAATTTA
TATTACCGCAC -> ATTACCGCACG
TATTACGGATT -> ATTACGGATTT
TATTATCTACC -> ATTATCTACCC
TATTATTAAAA -> ATTATTAAAAA
TATTGAGAGGC -> ATTGAGAGGCT
TATTGCAGTGA -> ATTGCAGTGAT
TATTGCTACGG -> ATTGCTACGGA
TCAAAGACAGT -> CAAAGACAGTG
TCAAATCTCTG -> CAAATCTCTGG
TCAAATGAACA -> CAAATGAACAG
TCAACGCGTCA -> CAACGCGTCAG
TCAAGCGAATA -> CAAGCGAATAC
TCAATAAGCAA -> CAATAAGCAAG
TCAATCCATGT -> CAATCCATGTT
TCAATGGTTAT -> CAATGGTTATC
TCAATTACAAG -> CAATTACAAGA
TCACAACCCCG -> CACAACCCCGA
TCACAGCATGA -> CACAGCATGAC
TCACAGTAGTA -> CACAGTAGTAC
TCACAGTGTCA -> CACAGTGTCAC
TCACCTGGGGA -> CACCTGGGGAT
TCACGAGGATC -> CACGAGGATCG
TCACTACGGCG -> CACTACGGCGT
TCACTCAGCAC -> CACTCAGCACA
TCACTTTACAT -> CACTTTACATT
TCAGAATCTAT -> CAGAATCTATC
TCAGAGTTTAA -> CAGAGTTTAAT
TCAGCACATCG -> CAGCACATCGA
TCAGCTCATTT -> CAGCTCATTTG
TCAGGATCAAA -> CAGGATCAAAG
TCAGGGTGTAT -> CAGGGTGTATC
TCAGTACATAT -> CAGTACATATC
TCAGTACGCTT -> CAGTACGCTTA
TCAGTCTCTCG -> CAGTCTCTCGC
TCAGTTGGCCG -> CAGTTGGCCGG
TCATAAAGCGA -> CATAAAGCGAC
TCATAATCCCG -> CATAATCCCGA
TCATAGGGACT -> CATAGGGACTA
TCATAGTAAGG -> CATAGTAAGGT
TCATTCAAATC -> CATTCAAATCT
TCATTGAGTTA -> CATTGAGTTAT
TCATTTGATCT -> CATTTGATCTC
TCATTTGCATC -> CATTTGCATCT
TCCAAGTACGT -> CCAAGTACGTC
TCCACACTGCC -> CCACACTGCCG
TCCACAGTAGG -> CCACAGTAGGT
TCCACTAGCGC -> CCACTAGCGCT
TCCACTCTCGA -> CCACTCTCGAG
TCCAGAGCTTT -> CCAGAGCTTTC
TCCAGAGGACG -> CCAGAGGACGC
TCCAGATTTTT -> CCAGATTTTTC
TCCAGCGCATG -> CCAGCGCATGT
TCCAGTGGCAG -> CCAGTGGCAGA
TCCATCTTGTT -> CCATCTTGTTC
TCCATGTTTTC -> CCATGTTTTCT
TCCCATCAGTA -> CCCATCAGTAC
TCCCGACAGTC -> CCCGACAGTCG
TCCGATTGTTA -> CCGATTGTTAA
TCCGCTATTGC -> CCGCTATTGCA
TCCGCTTTTAG -> CCGCTTTTAGC
TCCGGTGCCTG -> CCGGTGCCTGA
TCCGTGACTGG -> CCGTGACTGGC
TCCGTTTTTAG -> CCGTTTTTAGT
TCCTATGCAAC -> CCTATGCAACG
TCCTCTTGAAC -> CCTCTTGAACC
TCCTGACGCAT -> CCTGACGCATT
TCCTTAGTCGA -> CCTTAGTCGAA
TCCTTTCAACG -> CCTTTCAACGC
TCCTTTCATTC -> CCTTTCATTCA
TCGAAAACTGG -> CGAAAACTGGT
TCGAAAAGGGG -> CGAAAAGGGGC
TCGAAAAGTTG -> CGAAAAGTTGC
TCGAACCTTAG -> CGAACCTTAGG
TCGACGCCAAG -> CGACGCCAAGC
TCGACTGTTAA -> CGACTGTTAAA
TCGACTTATCG -> CGACTTATCGC
TCGAGCTTTGG -> CGAGCTTTGGC
TCGAGGGTGTA -> CGAGGGTGTAG
TCGATATTATC -> CGATATTATCT
TCGATGCCGTC -> CGATGCCGTCT
TCGCATGACGC -> CGCATGACGCT
TCGCGGGGGAT -> CGCGGGGGATT
TCGCGTGAATT -> CGCGTGAATTA
TCGCGTGGGTA -> CGCGTGGGTAA
TCGCTCGAGCT -> CGCTCGAGCTT
TCGCTTCAGGA -> CGCTTCAGGAT
TCGGAGATTTC -> CGGAGATTTCA
TCGGCAGTACC -> CGGCAGTACCA
TCGGTGGAAGT -> CGGTGGAAGTG
TCGGTTGATGG -> CGGTTGATGGG
TCGTACCGACT -> CGTACCGACTC
TCGTCACTTTA -> CGTCACTTTAC
TCGTCCGTGAC -> CGTCCGTGACT
TCGTCTCATAG -> CGTCTCATAGT
TCGTGACAGTG -> CGTGACAGTGG
TCGTGCACCTG -> CGTGCACCTGG
TCGTGCGCCTG -> CGTGCGCCTGT
TCGTGCGTCCT -> CGTGCGTCCTG
TCGTGGTCGTC -> CGTGGTCGTCA
TCGTTAGTAGC -> CGTTAGTAGCG
TCGTTGATCTA -> CGTTGATCTAG
TCTAATAAACC -> CTAATAAACCA
TCTACCCTTGA -> CTACCCTTGAA
TCTACGAGACT -> CTACGAGACTA
TCTACGTAGAA -> CTACGTAGAAT
TCTAGAGCTCG -> CTAGAGCTCGT
TCTAGCCACTC -> CTAGCCACTCC
TCTATCACGAG -> CTATCACGAGG
TCTATGCTATC -> CTATGCTATCG
TCTATTGAGAG -> CTATTGAGAGG
TCTCACTACGG -> CTCACTACGGC
TCTCAGAGTTT -> CTCAGAGTTTA
TCTCATAGTAA -> CTCATAGTAAG
TCTCCACTAGC -> CTCCACTAGCG
TCTCCAGCGCA -> CTCCAGCGCAT
TCTCCGCTATT -> CTCCGCTATTG
TCTCCGTTTTT -> CTCCGTTTTTA
TCTCGAGGGTG -> CTCGAGGGTGT
TCTCGCTCGAG -> CTCGCTCGAGC
TCTCGTGACAG -> CTCGTGACAGT
TCTCGTGCGCC -> CTCGTGCGCCT
TCTCTAGAGCT -> CTCTAGAGCTC
TCTCTATTGAG -> CTCTATTGAGA
TCTCTCGCTCG -> CTCTCGCTCGA
TCTCTGGTGTG -> CTCTGGTGTGA
TCTGAATCAAG -> CTGAATCAAGC
TCTGGCCCCGG -> CTGGCCCCGGT
TCTGGTGTGAG -> CTGGTGTGAGT
TCTGTTGTAGG -> CTGTTGTAGGG
TCTTACATCCC -> CTTACATCCCA
TCTTATAGCTG -> CTTATAGCTGG
TCTTGAACCGA -> CTTGAACCGAA
TCTTGAGCCGA -> CTTGAGCCGAT
TCTTGATGGAT -> CTTGATGGATT
TCTTGTTCGAC -> CTTGTTCGACT
TCTTTACCCCT -> CTTTACCCCTT
TCTTTAGCCAT -> CTTTAGCCATG
TGAAAATTGAC -> GAAAATTGACC
TGAAATGCAAT -> GAAATGCAATC
TGAACAGTAGA -> GAACAGTAGAA
TGAACCGAAAA -> GAACCGAAAAG
TGAACCGGTAA -> GAACCGGTAAG
TGAACTGCCAT -> GAACTGCCATG
TGAATCAAGCG -> GAATCAAGCGA
TGAATCGACTG -> GAATCGACTGT
TGAATGATGTA -> GAATGATGTAC
TGAATTATTAC -> GAATTATTACC
TGACAGTGGAG -> GACAGTGGAGC
TGACCACTGTC -> GACCACTGTCG
TGACCAGATCA -> GACCAGATCAT
TGACCCATGTC -> GACCCATGTCC
TGACGCATTCA -> GACGCATTCAG
TGACGCTATGT -> GACGCTATGTC
TGACGCTTAGC -> GACGCTTAGCT
TGACGGATTTA -> GACGGATTTAA
TGACGGTCTCT -> GACGGTCTCTA
TGACTGGCGAG -> GACTGGCGAGG
TGACTTTTTTT -> GACTTTTTTTG
TGAGAAGATCT -> GAGAAGATCTA
TGAGAGCAAAT -> GAGAGCAAATT
TGAGAGGCTGT -> GAGAGGCTGTA
TGAGCACCTTC -> GAGCACCTTCG
TGAGCCGATCC -> GAGCCGATCCG
TGAGGCTCGTC -> GAGGCTCGTCT
TGAGTGAGAAG -> GAGTGAGAAGA
TGAGTTATGAA -> GAGTTATGAAC,GAGTTATGAAC
TGATCTAGCCA -> GATCTAGCCAC
TGATCTCCGTT -> GATCTCCGTTT
TGATGAGTTAT -> GATGAGTTATG
TGATGGATTTG -> GATGGATTTGA
TGATGGGAATA -> GATGGGAATAC
TGATGTACGTG -> GATGTACGTGA
TGATTAAACAT -> GATTAAACATA
TGATTCACAAC -> GATTCACAACC
TGATTGGGCGG -> GATTGGGCGGA
TGATTTGTTCT -> GATTTGTTCTA
TGCAACGGCGT -> GCAACGGCGTC
TGCAATCGCTT -> GCAATCGCTTC
TGCACCCCTCA -> GCACCCCTCAG
TGCACCTGGGA -> GCACCTGGGAT
TGCACGGTGTG -> GCACGGTGTGT
TGCACTTTAGC -> GCACTTTAGCA
TGCAGATCCAC -> GCAGATCCACA
TGCAGTGATTA -> GCAGTGATTAA
TGCATCTATGC -> GCATCTATGCT
TGCATCTCCAG -> GCATCTCCAGC
TGCCAAAAGTC -> GCCAAAAGTCC
TGCCATGCAAC -> GCCATGCAACG
TGCCGAGCAAA -> GCCGAGCAAAA
TGCCGATTAGC -> GCCGATTAGCA
TGCCGTCTTGA -> GCCGTCTTGAG
TGCCTGATGAG -> GCCTGATGAGT
TGCCTTCAAAT -> GCCTTCAAATG
TGCCTTCTGGC -> GCCTTCTGGCC
TGCGACAACTA -> GCGACAACTAT
TGCGCCTGTGA -> GCGCCTGTGAT
TGCGGGTAAAT -> GCGGGTAAATG
TGCGTAACTCG -> GCGTAACTCGG
TGCGTCCTGAC -> GCGTCCTGACG
TGCGTCGTCCG -> GCGTCGTCCGT
TGCGTGGTGCC -> GCGTGGTGCCA
TGCTACACAGT -> GCTACACAGTC
TGCTACAGTGG -> GCTACAGTGGC
TGCTACGGACA -> GCTACGGACAT
TGCTAGTACTA -> GCTAGTACTAG
TGCTATCGGTG -> GCTATCGGTGG
TGCTTAAGCTC -> GCTTAAGCTCT
TGGAAGTGTCA -> GGAAGTGTCAC
TGGAGATTCTC -> GGAGATTCTCT
TGGAGCAACTC -> GGAGCAACTCC
TGGAGCTGCTA -> GGAGCTGCTAC
TGGATTTGATT -> GGATTTGATTG
TGGCACGTATT -> GGCACGTATTG
TGGCAGAGGCA -> GGCAGAGGCAT
TGGCAGTTAGA -> GGCAGTTAGAC
TGGCCCCGGTT -> GGCCCCGGTTC
TGGCCGGGGGC -> GGCCGGGGGCG
TGGCGAGGCGT -> GGCGAGGCGTG
TGGCGCTGGTC -> GGCGCTGGTCG
TGGCGGTGCTA -> GGCGGTGCTAG
TGGGAATACAA -> GGGAATACAAT
TGGGATCCACT -> GGGATCCACTC
TGGGCCCGTTC -> GGGCCCGTTCA
TGGGCGGAGTG -> GGGCGGAGTGC
TGGGGATCAGA -> GGGGATCAGAA
TGGGTAAGTAT -> GGGTAAGTATG
TGGGTCCGGTG -> GGGTCCGGTGC
TGGTCGAAAAG -> GGTCGAAAAGT
TGGTCGTCACT -> GGTCGTCACTT
TGGTGACCAGA -> GGTGACCAGAT
TGGTGAGGCTC -> GGTGAGGCTCG
TGGTGCCAAAA -> GGTGCCAAAAG
TGGTGTGAGTG -> GGTGTGAGTGA
TGGTTATCTTA -> GGTTATCTTAT
TGTAAGAGATT -> GTAAGAGATTA
TGTACGCGACT -> GTACGCGACTA
TGTACGTGAAT -> GTACGTGAATC
TGTAGAAAGGG -> GTAGAAAGGGA
TGTAGATCAAT -> GTAGATCAATA
TGTAGGACCGC -> GTAGGACCGCA
TGTAGGGGCCG -> GTAGGGGCCGC
TGTATCCACAG -> GTATCCACAGT
TGTATGAAATG -> GTATGAAATGC
TGTCAATGGTT -> GTCAATGGTTA
TGTCACAGCAT -> GTCACAGCATG
TGTCACTCAGC -> GTCACTCAGCA
TGTCAGTTGGC -> GTCAGTTGGCC
TGTCCTTAGTC -> GTCCTTAGTCG
TGTCGCGGGGG -> GTCGCGGGGGA
TGTCTCGTGCG -> GTCTCGTGCGC
TGTCTTGATGG -> GTCTTGATGGA
TGTGAGTGAGA -> GTGAGTGAGAA
TGTGATTTGTT -> GTGATTTGTTC
TGTGTCTTGAT -> GTGTCTTGATG
TGTGTTTTGGC -> GTGTTTTGGCG
TGTTAAACAAA -> GTTAAACAAAG
TGTTAAATGTA -> GTTAAATGTAC
TGTTCGACTTA -> GTTCGACTTAT
TGTTCTAATAA -> GTTCTAATAAA
TGTTGCGGGTA -> GTTGCGGGTAA
TGTTGTAGGGG -> GTTGTAGGGGC
TGTTTTCTCAG -> GTTTTCTCAGA
TGTTTTGGCGC -> GTTTTGGCGCT
TTAAAAACATC -> TAAAAACATCA
TTAAAATTTAG -> TAAAATTTAGC
TTAAACAAAGG -> TAAACAAAGGA
TTAAACATACG -> TAAACATACGG
TTAAACCCATT -> TAAACCCATTT
TTAAATGTACG -> TAAATGTACGC
TTAACCTCTTT -> TAACCTCTTTA
TTAACTCTTAC -> TAACTCTTACA
TTAAGCATCGA -> TAAGCATCGAT
TTAAGCTCTCG -> TAAGCTCTCGT
TTAATAAGGTT -> TAATAAGGTTC
TTACAAGACCC -> TACAAGACCCC
TTACAAGTGCG -> TACAAGTGCGA
TTACATCCCAT -> TACATCCCATC
TTACATTTTGT -> TACATTTTGTC
TTACCCCTTAC -> TACCCCTTACG
TTACCGCACGA -> TACCGCACGAC
TTACGACTACG -> TACGACTACGT
TTACGATCACC -> TACGATCACCT
TTACGCGCCCT -> TACGCGCCCTC
TTACGGATTTG -> TACGGATTTGC
TTAGACATCGC -> TAGACATCGCA
TTAGCAAATTG -> TAGCAAATTGC
TTAGCACGCCT -> TAGCACGCCTT
TTAGCCATGCA -> TAGCCATGCAC
TTAGCCTGCGT -> TAGCCTGCGTG
TTAGCTGGGTC -> TAGCTGGGTCC
TTAGCTTATAT -> TAGCTTATATT
TTAGGAGAAAC -> TAGGAGAAACA
TTAGGCGGTAC -> TAGGCGGTACC
TTAGTAGCGCA -> TAGTAGCGCAA
TTAGTATGACG -> TAGTATGACGC
TTAGTCGAACC -> TAGTCGAACCT
TTATAGCTGGA -> TATAGCTGGAG
TTATATGGAGC -> TATATGGAGCT
TTATATTATTA -> TATATTATTAA
TTATCGCGTGA -> TATCGCGTGAA
TTATCTACCCT -> TATCTACCCTT
TTATCTTATAG -> TATCTTATAGC
TTATGAACCGG -> TATGAACCGGT
TTATGAACTGC -> TATGAACTGCC
TTATGTGTCTT -> TATGTGTCTTG
TTATTAAAAAC -> TATTAAAAACA
TTATTAAAATT -> TATTAAAATTT
TTATTACCGCA -> TATTACCGCAC
TTCAAATCTCT -> TCAAATCTCTG
TTCAAATGAAC -> TCAAATGAACA
TTCAACGCGTC -> TCAACGCGTCA
TTCAATTACAA -> TCAATTACAAG
TTCACAACCCC -> TCACAACCCCG
TTCACAGTAGT -> TCACAGTAGTA
TTCAGGATCAA -> TCAGGATCAAA
TTCAGTACATA -> TCAGTACATAT
TTCATTCAAAT -> TCATTCAAATC
TTCATTGAGTT -> TCATTGAGTTA
TTCCAGTGGCA -> TCCAGTGGCAG
TTCCGCTTTTA -> TCCGCTTTTAG
TTCGAAAACTG -> TCGAAAACTGG
TTCGACGCCAA -> TCGACGCCAAG
TTCGACTTATC -> TCGACTTATCG
TTCGGTTGATG -> TCGGTTGATGG
TTCGTTGATCT -> TCGTTGATCTA
TTCTAATAAAC -> TCTAATAAACC
TTCTCAGAGTT -> TCTCAGAGTTT
TTCTCCGCTAT -> TCTCCGCTATT
TTCTCTAGAGC -> TCTCTAGAGCT
TTCTGAATCAA -> TCTGAATCAAG
TTCTGGCCCCG -> TCTGGCCCCGG
TTCTGTTGTAG -> TCTGTTGTAGG
TTGAAAATTGA -> TGAAAATTGAC
TTGAACCGAAA -> TGAACCGAAAA
TTGAATGATGT -> TGAATGATGTA
TTGACCCATGT -> TGACCCATGTC
TTGACGGATTT -> TGACGGATTTA
TTGAGAGGCTG -> TGAGAGGCTGT
TTGAGCCGATC -> TGAGCCGATCC
TTGAGTTATGA -> TGAGTTATGAA
TTGATCTAGCC -> TGATCTAGCCA
TTGATCTCCGT -> TGATCTCCGTT
TTGATGGATTT -> TGATGGATTTG
TTGATGGGAAT -> TGATGGGAATA
TTGATTGGGCG -> TGATTGGGCGG
TTGCACTTTAG -> TGCACTTTAGC
TTGCAGTGATT -> TGCAGTGATTA
TTGCATCTCCA -> TGCATCTCCAG
TTGCCGAGCAA -> TGCCGAGCAAA
TTGCGGGTAAA -> TGCGGGTAAAT
TTGCGTAACTC -> TGCGTAACTCG
TTGCTACACAG -> TGCTACACAGT
TTGCTACGGAC -> TGCTACGGACA
TTGCTTAAGCT -> TGCTTAAGCTC
TTGGCACGTAT -> TGGCACGTATT
TTGGCCGGGGG -> TGGCCGGGGGC
TTGGCGCTGGT -> TGGCGCTGGTC
TTGGCGGTGCT -> TGGCGGTGCTA
TTGGGCCCGTT -> TGGGCCCGTTC
TTGGGCGGAGT -> TGGGCGGAGTG
TTGGTGAGGCT -> TGGTGAGGCTC
TTGTAGGGGCC -> TGTAGGGGCCG
TTGTATGAAAT -> TGTATGAAATG
TTGTCTCGTGC -> TGTCTCGTGCG
TTGTTAAATGT -> TGTTAAATGTA
TTGTTCGACTT -> TGTTCGACTTA
TTGTTCTAATA -> TGTTCTAATAA
TTTAAGCATCG -> TTAAGCATCGA
TTTAATAAGGT -> TTAATAAGGTT
TTTACATTTTG -> TTACATTTTGT
TTTACCCCTTA -> TTACCCCTTAC
TTTACGCGCCC -> TTACGCGCCCT
TTTAGCAAATT -> TTAGCAAATTG
TTTAGCCATGC -> TTAGCCATGCA
TTTAGCCTGCG -> TTAGCCTGCGT
TTTAGCTTATA -> TTAGCTTATAT
TTTAGTATGAC -> TTAGTATGACG
TTTATATGGAG -> TTATATGGAGC
TTTCAACGCGT -> TTCAACGCGTC
TTTCACAGTAG -> TTCACAGTAGT
TTTCATTCAAA -> TTCATTCAAAT
TTTCCAGTGGC -> TTCCAGTGGCA
TTTCCGCTTTT -> TTCCGCTTTTA
TTTCGAAAACT -> TTCGAAAACTG
TTTCGACGCCA -> TTCGACGCCAA
TTTCTCAGAGT -> TTCTCAGAGTT
TTTCTCCGCTA -> TTCTCCGCTAT
TTTCTGTTGTA -> TTCTGTTGTAG
TTTGATCTCCG -> TTGATCTCCGT
TTTGATTGGGC -> TTGATTGGGCG
TTTGCATCTCC -> TTGCATCTCCA
TTTGCCGAGCA -> TTGCCGAGCAA
TTTGGCACGTA -> TTGGCACGTAT
TTTGGCGCTGG -> TTGGCGCTGGT
TTTGGGCCCGT -> TTGGGCCCGTT
TTTGTATGAAA -> TTGTATGAAAT
TTTGTCTCGTG -> TTGTCTCGTGC
TTTGTTCTAAT -> TTGTTCTAATA
TTTTACGCGCC -> TTTACGCGCCC
TTTTAGCCTGC -> TTTAGCCTGCG
TTTTAGTATGA -> TTTAGTATGAC
TTTTATATGGA -> TTTATATGGAG
TTTTCGAAAAC -> TTTCGAAAACT
TTTTCGACGCC -> TTTCGACGCCA
TTTTCTCAGAG -> TTTCTCAGAGT
TTTTGGCGCTG -> TTTGGCGCTGG
TTTTGTATGAA -> TTTGTATGAAA
TTTTGTCTCGT -> TTTGTCTCGTG
TTTTTAGTATG -> TTTTAGTATGA
TTTTTATATGG -> TTTTATATGGA
TTTTTCGAAAA -> TTTTCGAAAAC
TTTTTCGACGC -> TTTTCGACGCC
TTTTTGTATGA -> TTTTGTATGAA
TTTTTTGTATG -> TTTTTGTATGA
TTTTTTTGTAT -> TTTTTTGTATG
